prusakk	prusakk	N;NOM;SG
piäskuo	piäskuo	N;NOM;SG
kubu	kubu	N;NOM;SG
vuahti	vuahti	N;NOM;SG
huogiš	huogiš	ADJ;NOM;SG
bied	bied	N;NOM;SG
kuu	kuu	N;NOM;SG
raukk	raukk	N;ACC;SG
akk	akk	N;ACC;SG
bibliotek	bibliotek	N;ACC;SG
kroma	kroma	N;ACC;SG
pidädä	Pidäiš	V;COND;SG;3;POS;PRS
rukka	rukka	N;ACC;SG
küpse	küpse	ADJ;ACC;SG
sabilahat	sabilahat	N;NOM;SG
keza	kezal	N;AT+ESS;SG
hurst’	hurst’	N;ACC;SG
palava	palava	ADJ;ACC;SG
murreh	murreh	N;NOM;SG
tačme	tačme	N;ACC;SG
kovera	kovera	ADJ;NOM;SG
tuttau	tuttau	ADJ;NOM;SG
ainuoi	ainuoi	ADJ;NOM;SG
šur’dakka	šur’dakka	N;ACC;SG
lahnanparuliine	lahnanparuliine	N;ACC;SG
pulčukke	pulčukke	N;ACC;SG
selgeruoda	selgeruoda	N;ACC;SG
kynz’	kynded	N;NOM;PL
kušak	kušak	N;ACC;SG
pehmei	pehmei	ADJ;ACC;SG
paiže	paiže	N;ACC;SG
eväs	eväs	N;NOM;SG
paimenduskoht	paimenduskoht	N;NOM;SG
škilette	škilette	N;NOM;SG
tavarlauk	tavarlauk	N;NOM;SG
rüüstäžei	rüüstäžei	N;NOM;SG
sukkul	sukkul	N;ACC;SG
rauha	rauha	N;ACC;SG
kägintiäi	kägintiäi	N;ACC;SG
ukš	ukš	N;ACC;SG
konz	konz	PRO;NOM;SG
ramb	ramb	ADJ;NOM;SG
suai	suai	N;NOM;SG
ohd’aksed	ohd’aksed	N;NOM;SG
püštände	püštände	N;NOM;SG
keväd	keväd	N;ACC;SG
üks’tošt	üks’tošt	N;ACC;SG
adre	adre	N;ACC;SG
lendokoneh	lendokoneh	N;ACC;SG
täüze	täüze	N;ACC;SG
breičind	breičind	N;ACC;SG
leibä	leibä	N;ACC;SG
nuore	nuore	N;NOM;SG
pühkin	pühkin	N;ACC;SG
šättä	šättä	N;ACC;SG
yö	yö	N;ACC;SG
guikk	guikk	N;NOM;SG
sus’od	sus’od	N;NOM;SG
čakka	čakka	N;NOM;SG
fonar’i	fonar’i	N;NOM;SG
rihma	rihma	N;NOM;SG
venče	venče	N;NOM;SG
luasičču	luasičču	N;NOM;SG
sizar	sizar	N;NOM;SG
svuadibo	svuadibo	N;ACC;SG
razve	razve	N;NOM;SG
kärze	kärze	N;NOM;SG
atkala	atkala	N;NOM;SG
nuoraine	nuoraine	N;ACC;SG
pogost	pogost	N;ACC;SG
žiitte	žiitte	N;ACC;SG
robilo	robilo	N;NOM;SG
lykkida	lykin	V;IND;SG;1;POS;PRS
tuhu	tuhu	N;ACC;SG
kätüt	kätüt	N;ACC;SG
kondu	kondu	N;NOM;SG
pereh	pereh	N;NOM;SG
mietke	mietke	N;NOM;SG
kodi	kodit	N;NOM;PL
viäre	viäre	ADJ;ACC;SG
starikk	starikk	N;ACC;SG
kotkuo	kotkuo	N;ACC;SG
terä	terä	N;ACC;SG
vidi	vidi	N;NOM;SG
pihlaja	pihlaja	N;NOM;SG
taut	taut	N;NOM;SG
ad’v	ad’v	N;ACC;SG
särge	särge	N;ACC;SG
mänd	mänd	N;ACC;SG
huonduz	huonduz	N;ACC;SG
leski	leski	N;ACC;SG
maiduine	maiduine	N;ACC;SG
andilas	andilas	N;NOM;SG
liuhh	liuhh	N;NOM;SG
saide	saide	N;NOM;SG
abu	abu	N;NOM;SG
äippäi	äippäi	N;NOM;SG
mobil’nik	mobil’nik	N;ACC;SG
valatti	valatti	N;ACC;SG
siime	siime	N;NOM;SG
päivännouzm	päivännouzm	N;ACC;SG
sinine	sinine	ADJ;NOM;SG
val’mišttada	val’mištan	V;IND;SG;1;POS;PRS
hall	hall	N;ACC;SG
lapsenkaččuoi	lapsenkaččuoi	N;ACC;SG
teleg	teleg	N;ACC;SG
iho	iho	N;ACC;SG
kärištä	kärižen	V;IND;SG;1;POS;PRS
kezando	kezando	N;ACC;SG
tieduoinikka	tieduoinikka	N;NOM;SG
rassali	rassali	N;ACC;SG
nuo	nuo	PRO;ACC;SG
ottada	otan	V;IND;SG;1;POS;PRS
uuhuine	uuhuine	N;ACC;SG
miel	miel	N;ACC;SG
huulet	huulet	N;NOM;PL
čerkkova	čerkkova	N;NOM;SG
sustuava	sustuava	N;NOM;SG
vuon	vuon	N;NOM;SG
kuuž	kuuž	N;ACC;SG
garbol	garbol	N;ACC;SG
syguz’kuu	syguz’kuu	N;NOM;SG
nahkasiibi	nahkasiibi	N;ACC;SG
koivungriba	koivungriba	N;ACC;SG
päčč	päčč	N;NOM;SG
jantari	jantari	N;NOM;SG
vuoz’	vuoz’	N;NOM;SG
toine	toine	ADJ;ACC;SG
viha	viha	N;ACC;SG
kindie	kindie	ADJ;NOM;SG
smiel	smiel	ADJ;ACC;SG
pedr	pedr	N;ACC;SG
labje	labje	N;ACC;SG
ruočit	ruočit	N;ACC;SG
muode	muode	N;ACC;SG
pogoste	pogoste	N;ACC;SG
loppumyönd	loppumyönd	N;ACC;SG
kibu	kibu	N;ACC;SG
dyrk	dyrkke	ADJ;ACC;SG
ambund	ambund	N;ACC;SG
tuukkaja	tuukkaja	N;ACC;SG
pulčukk	pulčukk	N;NOM;SG
miä	miä	PRO;NOM;SG
doršš	doršš	N;ACC;SG
bir’b	bir’b	N;NOM;SG
läheliine	läheliine	ADJ;NOM;SG
kazvada	kazvan	V;IND;SG;1;POS;PRS
kezä	kezä	N;NOM;SG
neičukke	neičukke	N;NOM;SG
ristikanz	ristikanz	N;ACC;SG
suabra	suabra	N;ACC;SG
enžimašar’g	enžimašar’g	N;ACC;SG
astuda	astunemme	V;POT;PL;1;POS;PRS
kuolii	kuolii	ADJ;NOM;SG
štanad	štanad	N;NOM;SG
kirnikke	kirnikke	ADJ;NOM;SG
pera	pera	N;NOM;SG
d’augumiäčč	d’augumiäčč	N;NOM;SG
čakk	čakk	N;NOM;SG
ahmuoi	ahmuoi	N;ACC;SG
suolvakke	suolvakke	N;ACC;SG
minä	minul	PRO;AT+ESS;SG
saduli	saduli	N;NOM;SG
palau	palau	ADJ;ACC;SG
čaivuoi	čaivuoi	N;NOM;SG
lyydi	lyydi	N;ACC;SG
artut’	artut’	N;ACC;SG
gurba	gurba	N;ACC;SG
verkkomiäčč	verkkomiäčč	N;NOM;SG
t’otka	t’otkad	N;PRT;SG
niemak	niemak	N;NOM;SG
maske	maske	N;NOM;SG
rahkamaido	rahkamaido	N;NOM;SG
bulke	bulke	N;NOM;SG
kangasbrujat	kangasbrujat	N;NOM;SG
dobruoi	dobruoi	ADJ;ACC;SG
suomelaažed	suomelaažed	N;NOM;SG
kagle	kagle	N;ACC;SG
tuatandam	tuatandam	N;NOM;SG
hein’kuu	hein’kuu	N;NOM;SG
olda	oližin	V;COND;SG;1;POS;PRS
käzirüüstö	käzirüüstö	N;NOM;SG
bohatte	bohatte	ADJ;NOM;SG
bezmen’	bezmen’	N;NOM;SG
ikkun	ikkun	N;NOM;SG
tuohuz	tuohuz	N;NOM;SG
vauged	vauged	ADJ;ACC;SG
Ven’a	Ven’a	PROPN;ACC;SG
br’ukve	br’ukve	N;ACC;SG
šižlik	šižlik	N;NOM;SG
pöčüöi	pöčüöi	N;NOM;SG
libei	libei	ADJ;NOM;SG
karvahaine	karvahaine	ADJ;NOM;SG
rista	rista	N;ACC;SG
kaludin	kaludin	N;NOM;SG
last	last	N;NOM;SG
hobed	hobed	N;NOM;SG
rikkoda	rikon	V;IND;SG;1;POS;PRS
rodit’al’ad	rodit’al’ad	N;NOM;SG
skluad	skluad	N;NOM;SG
olda	ei ole	V;IPFV;IND;SG;3;NEG;PST
laineh	laineh	N;NOM;SG
gimnast	gimnast	N;NOM;SG
liuhe	liuhe	N;ACC;SG
huomez	huomesel	N;AT+ESS;SG
ahmo	ahmo	N;NOM;SG
died	died	N;ACC;SG
puške	puške	N;NOM;SG
bezmeni	bezmeni	N;ACC;SG
kuive	kuive	ADJ;NOM;SG
tytti	tytti	N;NOM;SG
kupče	kupče	N;NOM;SG
vihištä	vihižen	V;IND;SG;1;POS;PRS
lapsi	lapsidet	N;NOM;PL
nuage	nuage	N;NOM;SG
posestru	posestru	N;NOM;SG
püörei	püörei	ADJ;ACC;SG
tagine	tagine	ADJ;NOM;SG
zaverkke	zaverkke	N;NOM;SG
ižindam	ižindam	N;NOM;SG
gimnazii	gimnazijad	N;PRT;SG
kiiškot	kiiškot	N;ACC;SG
tabletk	tabletk	N;ACC;SG
kanzalližuus	kanzalližuus	N;ACC;SG
salba	salba	N;ACC;SG
segoittada	segoitettu	V.PTCP;PST;PASS
kindei	kindei	ADJ;NOM;SG
gribe	gribad	N;NOM;PL
poiga	poiga	N;NOM;SG
plet’t’ida	pletin	V;IND;SG;1;POS;PRS
slabuu	slabuu	ADJ;NOM;SG
liettä	liined	V;IND;SG;2;POS;PRS
miituine	miituine	ADJ;NOM;SG
matkudovariš	matkudovariš	N;ACC;SG
keväz	keväz	N;ACC;SG
magadussija	magadussija	N;ACC;SG
astuda	ei ole astunu	V;PRF;IND;SG;3;NEG;PST
koivuine	koivuine	ADJ;NOM;SG
voimatoine	voimatoine	N;ACC;SG
tattuoi	tattuoi	N;NOM;SG
dyry	dyry	N;NOM;SG
plettida	pletin	V;IND;SG;1;POS;PRS
čidži	čidži	N;NOM;SG
hyubi	hyubi	N;NOM;SG
d’äiče	d’äiče	N;NOM;SG
ägez	ägez	N;NOM;SG
pitaidakseh	pitaimmos	V;IND;SG;1;POS;PRS;REFL
bramori	bramori	N;NOM;SG
sivu	sivu	N;ACC;SG
kangaspuut	kangaspuut	N;NOM;SG
groba	groba	N;NOM;SG
hibje	hibje	N;NOM;SG
sygyz’	sygyzel	N;AT+ESS;SG
sabilahad	sabilahad	N;NOM;SG
liipukkane	liipukkane	N;NOM;SG
dielo	dielo	N;NOM;SG
hong	hong	N;ACC;SG
rago	rago	N;ACC;SG
hyvä	hyväd	ADJ;NOM;PL
bor	bor	N;NOM;SG
pistolette	pistolette	N;NOM;SG
gr’yhe	gr’yhe	N;NOM;SG
kulma	kulma	N;NOM;SG
kandelta	kandelen	V;IND;SG;1;POS;PRS
hyvä	hyvä	ADJ;NOM;SG
zagatk	zagatk	N;ACC;SG
vahalaukku	vahalaukku	N;ACC;SG
nuot	nuot	N;ACC;SG
lago	lago	N;NOM;SG
kuhne	kuhne	N;ACC;SG
kauha	kauha	N;NOM;SG
telegä	telegä	N;ACC;SG
rädžäittädä	rädžätan	V;IND;SG;1;POS;PRS
üö	üö	N;NOM;SG
hebo	hebo	N;NOM;SG
keli	keli	N;NOM;SG
sizär	sizär	N;NOM;SG
sild	sild	N;ACC;SG
vüö	vüö	N;ACC;SG
ruozme	ruozme	N;NOM;SG
mougotid	mougotid	PRO;NOM;SG
voin	voin	N;NOM;SG
himo	himo	N;ACC;SG
käzi	käzi	N;ACC;SG
neveska	neveska	N;NOM;SG
očča	očča	N;ACC;SG
virittädä	viritän	V;IND;SG;1;POS;PRS
aloveh	alovehespäi	N;IN+ABL;SG
kirjutus	kirjutuste	N;PRT;SG
pühä	pühä	ADJ;ACC;SG
hardijad	hardijad	N;ACC;SG
kanzallizus	kanzallizus	N;NOM;SG
kandanpiä	kandanpiä	N;NOM;SG
d’ärvi	d’ärvi	N;ACC;SG
palle	palle	N;ACC;SG
ruuhi	ruuhi	N;NOM;SG
laukke	laukke	N;ACC;SG
nelläšpäi	nelläšpäi	N;NOM;SG
sumb	sumb	ADJ;NOM;SG
kartohk	kartohk	N;ACC;SG
ramke	ramke	N;ACC;SG
naglaine	naglaine	N;ACC;SG
hango	hango	N;ACC;SG
karjalaine	karjalaine	N;ACC;SG
huomeš	huomeš	N;ACC;SG
paštand	paštand	N;NOM;SG
kiškoi	kiškojat	N;NOM;PL
okl’uččim	okl’uččim	N;ACC;SG
sroičanpäi	sroičanpäi	N;NOM;SG
huuht	huuht	N;NOM;SG
tavi	tavi	N;NOM;SG
porč	porč	N;ACC;SG
biegluoi	biegluoi	N;ACC;SG
kondii	kondii	N;ACC;SG
kajos	kajos	ADJ;ACC;SG
puhtaš	puhtaš	ADJ;ACC;SG
dengad	dengad	N;NOM;PL
kohemdamiine	kohendamišt	N;PRT;SG
korvuoi	korvuoi	N;NOM;SG
iža	iža	N;ACC;SG
sorminahke	sorminahke	N;NOM;SG
leib	leib	N;NOM;SG
kabluk	kabluk	N;NOM;SG
huomneščaju	huomneščaju	N;NOM;SG
r’abin	r’abin	N;NOM;SG
kajuoi	kajuoi	N;ACC;SG
zautreni	zautreni	N;NOM;SG
pühäpäiv	pühäpäiv	N;NOM;SG
puu	puu	N;ACC;SG
grib	gribad	N;NOM;PL
tahko	tahko	N;ACC;SG
punaldus	punaldus	N;NOM;SG
pitäččüheinä	pitäččüheinä	N;NOM;SG
lämbittädä	lämbitän	V;IND;SG;1;POS;PRS
suo	suo	N;ACC;SG
bruus	bruus	N;ACC;SG
navedida	en navedi	V;IND;SG;1;NEG;PRS
šiim	šiim	N;ACC;SG
külü	külü	N;NOM;SG
tuatindama	tuatindama	N;NOM;SG
vazaraine	vazaraine	N;NOM;SG
badminton	badminton	N;ACC;SG
taimen	taimen	N;ACC;SG
kynzi	kynzi	N;ACC;SG
kell	kell	N;ACC;SG
lähtedä	lähtöu	V;IND;SG;3;POS;PRS
net	net	PRO;NOM;SG
kartat	kartat	N;NOM;SG
vikateh	vikateh	N;NOM;SG
surčin	surčin	N;ACC;SG
huole	huole	N;ACC;SG
lente	lente	N;ACC;SG
karte	karte	N;ACC;SG
haukkuda	haukun	V;IND;SG;1;POS;PRS
kagl	kagl	N;ACC;SG
doroganviiteh	doroganviiteh	N;NOM;SG
habuk	habuk	N;NOM;SG
pordimoi	pordimoi	N;NOM;SG
vakaine	vakaine	N;ACC;SG
raiživo	raiživo	N;NOM;SG
paikke	paikke	N;NOM;SG
tagaliine	tagaliine	ADJ;ACC;SG
mečče	mečile	N;AT+ALL;PL
taudi	taudi	N;NOM;SG
rungo	rungo	N;NOM;SG
anze	anze	N;NOM;SG
turist	turist	N;NOM;SG
sumke	sumke	N;NOM;SG
kibos	kibos	N;ACC;SG
nasmorka	nasmorka	N;ACC;SG
stameske	stameske	N;ACC;SG
t’otka	t’otka	N;ACC;SG
sroičča	sroičča	N;ACC;SG
bugri	bugri	N;NOM;SG
kujo	kujo	N;NOM;SG
astuda	ette liene astunu	V;PRF;POT;PL;2;NEG;PRS
pedäjä	pedäjä	N;NOM;SG
räüstäs	räüstäs	N;ACC;SG
karve	karve	N;NOM;SG
perzeluud	perzeluud	N;ACC;SG
lahk	lahk	N;NOM;SG
polučida	polučin	V;IND;SG;1;POS;PRS
zavalim	zavalim	N;NOM;SG
vävy	vävy	N;ACC;SG
keškimaine	keškimaine	ADJ;NOM;SG
kuokke	kuokke	N;NOM;SG
mal’ar	mal’ar	N;NOM;SG
kynä	kynä	N;ACC;SG
kohtalline	kohtalline	ADJ;ACC;SG
praud	praud	N;NOM;SG
aščat	aščat	N;ACC;SG
kard’alaine	kard’alaine	N;ACC;SG
sadu	sadu	N;ACC;SG
vuassa	vuassa	N;NOM;SG
siegle	siegle	N;NOM;SG
turkki	turkki	N;NOM;SG
kandada	kandan	V;IND;SG;1;POS;PRS
zamaske	zamaske	N;ACC;SG
kivi	kivi	N;ACC;SG
kerda	kerda	N;ACC;SG
olda	oldah	V;IND;PL;3;POS;PRS
pehmed	pehmed	N;ACC;SG
obšivke	obšivke	N;ACC;SG
huuhkaja	huuhkaja	N;ACC;SG
astuda	astutakkah	V;IMP;PL;3;POS
varz	varz	N;NOM;SG
däred	däred	ADJ;NOM;SG
kulakke	kulakke	N;NOM;SG
magata	magadan	V;IND;SG;1;POS;PRS
aige	aigal	N;AT+ESS;SG
svuat	svuat	N;NOM;SG
tuomane	tuomane	N;NOM;SG
pyhkidä	pyhkin	V;IND;SG;1;POS;PRS
miituine	miituine	PRO;NOM;SG
pedra	pedra	N;ACC;SG
savu	savu	N;ACC;SG
olan’d’	olan’d’	N;ACC;SG
sdače	sdače	N;ACC;SG
šiä	šiä	N;ACC;SG
miske	miske	N;ACC;SG
ongi	ongi	N;NOM;SG
kuok	kuok	N;NOM;SG
tekst	tekst	N;ACC;SG
ne	ned	PRO;NOM;PL
käskende	käskende	N;ACC;SG
tahtaz	tahtaz	N;ACC;SG
nevesk	nevesk	N;ACC;SG
lind	lind	N;ACC;SG
kägöntäi	kägöntäi	N;NOM;SG
kuolenda	kuolenda	N;NOM;SG
laučče	laučče	N;NOM;SG
päivännouzu	päivännouzu	N;NOM;SG
tapant	tapant	N;NOM;SG
vuahti	vuahti	N;ACC;SG
kubu	kubu	N;ACC;SG
piäskuo	piäskuo	N;ACC;SG
katus	katus	N;ACC;SG
muu	muidh	ADJ;IN+ALL;PL
svit’il	svit’il	N;ACC;SG
evä	evä	N;ACC;SG
mečče	mecal	N;AT+ESS;SG
huogam	huogam	N;ACC;SG
počinpoiga	počinpoiga	N;ACC;SG
kapotte	kapotte	N;ACC;SG
emälammas	emälammas	N;ACC;SG
orahaižed	orahaižed	N;NOM;SG
loitoine	loitoine	ADJ;NOM;SG
vol’noi	vol’noi	ADJ;NOM;SG
keskimbäne	keskimbäne	ADJ;ACC;SG
bubarko	bubarko	N;ACC;SG
levei	levei	ADJ;ACC;SG
uksi	uksi	N;ACC;SG
arššin	arššin	N;NOM;SG
muške	muške	N;NOM;SG
hieno	hieno	ADJ;ACC;SG
rusket	rusket	ADJ;ACC;SG
mända	mänen	V;IND;SG;1;POS;PRS
nuore	nuore	N;ACC;SG
sekund	sekund	N;ACC;SG
orbo	orbo	N;ACC;SG
vepsälaine	vepsälaine	N;ACC;SG
papp	papp	N;NOM;SG
late	late	N;NOM;SG
lämmä	lämmä	ADJ;NOM;SG
lotuoi	lotuoi	N;ACC;SG
d’yvä	d’yvä	N;NOM;SG
kindet	kindet	ADJ;NOM;SG
ainag	ainag	ADJ;NOM;SG
vihata	vihadan	V;IND;SG;1;POS;PRS
kirpp	kirpp	N;ACC;SG
tutkamet	tutkamet	N;ACC;SG
ymbärtä	ymbärdän	V;IND;SG;1;POS;PRS
halle	halle	N;ACC;SG
särg	särg	N;ACC;SG
hapannu	hapannu	ADJ;NOM;SG
pühäpäivä	pühäpäivä	N;ACC;SG
pereh	pereh	N;ACC;SG
lauk	lauk	N;ACC;SG
miär	miär	N;ACC;SG
poro	poro	N;NOM;SG
d’ablokke	d’ablokke	N;NOM;SG
sallo	sallo	N;NOM;SG
keühne	keühne	N;ACC;SG
mečče	mečče	N;ACC;SG
hüvä	hüvä	ADJ;ACC;SG
mähändä	mähändä	N;NOM;SG
kukkar	kukkar	N;NOM;SG
miehe	miehe	N;NOM;SG
polossu	polossu	N;ACC;SG
kazvain	kazvain	N;NOM;SG
kunna	kunna	PRO;NOM;SG
pakaažkuu	pakaažkuu	N;NOM;SG
kuorzuda	kuorzun	V;IND;SG;1;POS;PRS
boltaida	boltain	V;IND;SG;1;POS;PRS
astuda	et astunuiš	V;IPFV;COND;SG;2;NEG;PST
leikkalmas	leikkalmas	N;ACC;SG
pilluine	pilluine	N;ACC;SG
uros	uros	N;ACC;SG
muštolahd’	muštolahd’	N;NOM;SG
pöllö	pöllö	N;ACC;SG
ruahto	ruahto	N;NOM;SG
orov	orov	N;NOM;SG
kägentiäi	kägentiäi	N;NOM;SG
koditoi	koditoi	ADJ;ACC;SG
syguz’kuu	syguz’kuu	N;ACC;SG
sustuava	sustuava	N;ACC;SG
čerkkova	čerkkova	N;ACC;SG
vuon	vuon	N;ACC;SG
künäbrus	künäbrus	N;NOM;SG
virgu	virgu	N;ACC;SG
liäv	liäv	N;ACC;SG
elaige	elaigad	N;PRT;SG
voittai	voittai	N;NOM;SG
tieduoinikka	tieduoinikka	N;ACC;SG
tuluppe	tuluppe	N;NOM;SG
huodr	huodr	N;NOM;SG
pino	pino	N;NOM;SG
oppiteluz	oppiteluz	N;NOM;SG
lehenkanda	lehenkanda	N;NOM;SG
nälge	näl’gäh	N;IN+ALL;SG
kattil	kattil	N;NOM;SG
kon’aparž	kon’aparž	N;ACC;SG
rahkaveži	rahkaveži	N;ACC;SG
viikateh	viikateh	N;ACC;SG
p’atn	p’atn	N;ACC;SG
raštava	raštava	N;ACC;SG
vitilin	vitilin	N;NOM;SG
nelläšpäivä	nelläšpäivä	N;ACC;SG
libie	libie	ADJ;ACC;SG
huodes	huodes	N;ACC;SG
küünäl	küünäl	N;NOM;SG
lomuta	lomudan	V;IND;SG;1;POS;PRS
sugunimi	sugunimi	N;NOM;SG
peipuone	peipuone	N;NOM;SG
kolod	kolod	N;ACC;SG
kauho	kauho	N;ACC;SG
vähä	vähä	ADJ;ACC;SG
rikaš	rikaš	ADJ;ACC;SG
mieli	miel’te	N;PRT;SG
gribe	gribe	N;ACC;SG
kolakka	kolakka	N;NOM;SG
krane	krane	N;ACC;SG
lukku	lukku	N;ACC;SG
kieltä	kieldän	V;IND;SG;1;POS;PRS
puuhine	puuhine	ADJ;NOM;SG
tili	tili	N;ACC;SG
ad’vo	ad’vo	N;ACC;SG
razvaine	razvaine	ADJ;NOM;SG
hebočče	hebočče	N;ACC;SG
mavruoi	mavruoi	N;ACC;SG
lizä	lizä	N;ACC;SG
pruaznik	pruaznik	N;ACC;SG
selgäpii	selgäpii	N;ACC;SG
barčč	barčč	N;NOM;SG
šügüžü	šügüžü	N;ACC;SG
löpyöi	löpyöi	N;ACC;SG
silde	silde	N;ACC;SG
roude	roude	N;NOM;SG
puarm	puarm	N;ACC;SG
svorc	svorc	N;NOM;SG
motorveneh	motorveneh	N;ACC;SG
miez	miehel	N;AT+ESS;SG
tuhka	tuhka	N;NOM;SG
kidžurat	kidžurat	N;NOM;SG
tytrindam	tytrindam	N;NOM;SG
suomelaažed	suomelaažed	N;ACC;SG
sula	sula	ADJ;NOM;SG
mutnuoi	mutnuoi	ADJ;NOM;SG
talvi	talvi	N;NOM;SG
viešči	viešči	N;NOM;SG
mečče	meči-nke-neh	N;COM;PL
pöküö	pöküö	N;ACC;SG
reiž	reiž	N;ACC;SG
tuuli	tuuli	N;NOM;SG
gor’a	gor’a	ADJ;NOM;SG
uskoda	uskoi	V;IPFV;IND;SG;3;POS;PST
zale	zale	N;ACC;SG
tammi	tammi	N;ACC;SG
säkki	säkki	N;ACC;SG
tavaranlauk	tavaranlauk	N;ACC;SG
lappalaižet	lappalaižet	N;ACC;SG
vaugedven’alaine	vaugedven’alaine	N;ACC;SG
iga	iga	N;NOM;SG
pägie	pägie	N;NOM;SG
ahmo	ahmo	N;ACC;SG
polos	polosat	N;NOM;PL
totkut	totkut	N;NOM;SG
hämärä	hämärä	N;NOM;SG
luht	luht	N;NOM;SG
pual’movoi	pual’movoi	ADJ;ACC;SG
nasmork	nasmork	N;NOM;SG
Viro	Viro	PROPN;NOM;SG
jämei	jämei	ADJ;ACC;SG
šitte	šitte	N;NOM;SG
räkk	räkk	N;NOM;SG
polosat	polosat	N;NOM;SG
vago	vago	N;NOM;SG
hiam	hiam	N;NOM;SG
pangaižet	pangaižet	N;NOM;SG
mahlu	mahlu	N;NOM;SG
kodi	kodid	N;PRT;SG
muzikant	muzikant	N;NOM;SG
onduz	onduz	N;ACC;SG
vieras	vieras	ADJ;ACC;SG
älü	älü	N;NOM;SG
niken	niken	PRO;ACC;SG
hištorijahine	hištorijahižen	ADJ;ACC;SG
niegla	niegla	N;NOM;SG
vävü	vävü	N;ACC;SG
tabak	tabak	N;ACC;SG
guikka	guikka	N;ACC;SG
sanoda	sanou	V;IND;SG;3;POS;PRS
ruozm	ruozm	N;ACC;SG
mečče	meciči	N;PROL;PL
staršin	staršin	N;ACC;SG
uuhut	uuhut	N;ACC;SG
šepp	šepp	N;NOM;SG
maima	maima	N;ACC;SG
urok	urokad	N;NOM;PL
vilu	viluh	N;IN+ALL;SG
raukka	raukka	N;NOM;SG
kehno	kehno	N;NOM;SG
kodinižände	kodinižände	N;NOM;SG
taute	taute	N;ACC;SG
avadin	avadin	N;ACC;SG
kušakk	kušakk	N;NOM;SG
tattuoi	tattuoi	N;ACC;SG
akke	akkannu	N;FRML;SG
laiha	laiha	ADJ;ACC;SG
kalmižmua	kalmižmua	N;NOM;SG
karandaša	karandaša	N;NOM;SG
merdaane	merdaane	N;NOM;SG
haude	haude	N;ACC;SG
kukkur	kukkur	N;NOM;SG
kaivo	kaivo	N;NOM;SG
silme	silme	N;NOM;SG
šeppä	šeppä	N;ACC;SG
čuassud	čuassud	N;ACC;SG
virši	virši	N;NOM;SG
ränd	ränd	N;NOM;SG
käbälä	käbälä	N;ACC;SG
tuhukuu	tuhukuu	N;ACC;SG
halatte	halatte	N;ACC;SG
ižändä	ižändä	N;NOM;SG
kalliš	kalliš	ADJ;ACC;SG
karku	karku	N;ACC;SG
nagriž	nagriž	N;NOM;SG
čurčettada	čurčettau	V;IND;SG;1;POS;PRS
lammas	lammas	N;NOM;SG
talme	talme	N;NOM;SG
veres	veres	ADJ;NOM;SG
nenä	nenä	N;NOM;SG
trupka	trupka	N;ACC;SG
polatti	polatti	N;NOM;SG
hapannuh	hapannuh	ADJ;NOM;SG
kirz	kirz	N;ACC;SG
mel’onke	mel’onke	N;ACC;SG
koruoi	koruoi	N;ACC;SG
bezmen	bezmen	N;ACC;SG
türü	türü	N;ACC;SG
sobat	sobat	N;ACC;SG
lehmuz	lehmuz	N;NOM;SG
suad’bo	suad’bo	N;NOM;SG
čaaju	čaaju	N;NOM;SG
šiima	šiima	N;NOM;SG
härkkimä	härkkimä	N;NOM;SG
kird’aine	kird’ašte	N;PRT;SG
grubuoi	grubuoi	ADJ;NOM;SG
päiv	päiv	N;NOM;SG
pidädä	pidan	V;IND;SG;1;POS;PRS
puaks	puaks	ADJ;NOM;SG
mečče	meččäd	N;PRT;SG
ned	ned	PRO;NOM;SG
mua	muad	N;PRT;SG
salo	salo	N;ACC;SG
kopče	kopče	N;ACC;SG
opastai	opastajan	N;BYWAY;SG
kivi	kivet	N;NOM;PL
kargie	kargie	ADJ;NOM;SG
puarus	puarus	N;NOM;SG
kuoppa	kuoppa	N;NOM;SG
šurd’ak	šurd’ak	N;NOM;SG
ruozme	ruozme	N;ACC;SG
kargei	kargei	ADJ;NOM;SG
tuat	tuat	N;ACC;SG
röünääne	röünääne	N;NOM;SG
majai	majai	N;ACC;SG
palgu	palgu	N;ACC;SG
susieda	susieda	N;ACC;SG
verez	verez	ADJ;NOM;SG
bl’ednuoi	bl’ednuoi	ADJ;ACC;SG
oigie	oigie	ADJ;NOM;SG
lampadke	lampadke	N;NOM;SG
čuas	čuas	N;NOM;SG
kandanpiä	kandanpiä	N;ACC;SG
laihin	laihin	N;ACC;SG
kanzallizus	kanzallizus	N;ACC;SG
süöttuö	süöttuö	N;NOM;SG
n’umal	n’umal	N;NOM;SG
lähin	lähin	ADJ;ACC;SG
korvuoi	korvuoi	N;ACC;SG
ard	ard	N;NOM;SG
pühäpäiv	pühäpäiv	N;ACC;SG
trupk	trupk	N;NOM;SG
käbryöossieni	käbryöossieni	N;NOM;SG
ilme	ilme	N;NOM;SG
ruoste	ruoste	N;NOM;SG
kangaz	kangaz	N;ACC;SG
nadežida	nadežin	V;IND;SG;1;POS;PRS
karassi	karassi	N;NOM;SG
kukuoi	kukuoi	N;ACC;SG
drožd’at	drožd’at	N;ACC;SG
zvonida	zvonin	V;IND;SG;1;POS;PRS
leuga	leuga	N;NOM;SG
riibu	riibu	N;NOM;SG
toži	toži	N;ACC;SG
piendar	piendar	N;ACC;SG
kopeik	kopeik	N;ACC;SG
ristituatto	ristituatto	N;ACC;SG
kartinke	kartinke	N;ACC;SG
n’auguda	n’augui	V;IPFV;IND;SG;3;POS;PST
mečče	mečillyö	N;TERM;PL
külü	külü	N;ACC;SG
meckana	meckana	N;NOM;SG
käžne	käžne	N;ACC;SG
čaške	čaške	N;ACC;SG
bašmakke	bašmakke	N;NOM;SG
astuda	et liene astunu	V;PRF;POT;SG;2;NEG;PRS
ohvotnikke	ohvotnikke	N;ACC;SG
dube	dube	N;NOM;SG
punoda	punon	V;IND;SG;1;POS;PRS
rokk	rokk	N;NOM;SG
čer’kou	čer’kou	N;NOM;SG
viehh	viehh	N;NOM;SG
raiživo	raiživo	N;ACC;SG
rukke	rukke	N;NOM;SG
šilda	šilda	N;NOM;SG
bošši	bošši	N;ACC;SG
ruame	ruame	N;NOM;SG
oks	oks	N;NOM;SG
kangasbrujat	kangasbrujat	N;ACC;SG
rahkamaido	rahkamaido	N;ACC;SG
madoine	madoine	N;NOM;SG
lapp	lapp	N;ACC;SG
šitböröi	šitböröi	N;ACC;SG
d’ogi	d’ogi	N;ACC;SG
kiviručču	kiviručču	N;NOM;SG
bank	bankas	N;IN+ESS;SG
pedäjä	pedäjä	N;ACC;SG
kujo	kujo	N;ACC;SG
vihande	vihande	ADJ;ACC;SG
kudakui	kudakui	PRO;NOM;SG
künži	künži	N;ACC;SG
muruine	muruine	N;NOM;SG
dovarišše	dovarišše	N;ACC;SG
röun’	röun’	N;ACC;SG
kegäleh	kegäleh	N;ACC;SG
pualikka	pualikka	N;NOM;SG
ristrihme	ristrihme	N;NOM;SG
doske	doske	N;NOM;SG
Ruočči	Ruočči	PROPN;ACC;SG
koire	koirad	N;PRT;SG
rusked	rusked	ADJ;NOM;SG
hieroda	hierоn	V;IND;SG;1;POS;PRS
Vašakke	Vašakke	PROPN;NOM;SG
korvo	korvo	N;ACC;SG
lastu	lastu	N;ACC;SG
ogahane	ogahane	N;ACC;SG
tykke	tykke	N;ACC;SG
sepp	sepp	N;ACC;SG
kengänombelii	kengänombelii	N;ACC;SG
pačas	pačas	N;NOM;SG
omad	omad	N;PRT;SG
pöčüöi	pöčüöi	N;ACC;SG
suomus	suomus	N;NOM;SG
šižlik	šižlik	N;ACC;SG
suga	suga	N;NOM;SG
meččo	meččo	N;NOM;SG
huodar	huodar	N;NOM;SG
raba	raba	N;ACC;SG
pihk	pihk	N;ACC;SG
petkel	petkel	N;ACC;SG
divan	divan	N;NOM;SG
sort	sort	N;NOM;SG
tytti	tytti	N;ACC;SG
niegle	niegle	N;NOM;SG
borčče	borčče	N;NOM;SG
šäigiš	šäigiš	N;NOM;SG
taltta	taltta	N;NOM;SG
tervehyz	tervehyz	N;ACC;SG
mečče	mečäs	N;IN+ABL;SG
viärys	viärys	N;NOM;SG
olda	oližit	V;COND;SG;2;POS;PRS
hind	hind	N;NOM;SG
muigie	muigie	ADJ;NOM;SG
linn	linn	N;NOM;SG
snuapp	snuapp	N;NOM;SG
hein	hein	N;ACC;SG
astiit	astiit	N;ACC;SG
mašinke	mašinke	N;ACC;SG
tera	tera	N;ACC;SG
hapata	hapanen	V;IND;SG;1;POS;PRS
koukk	koukk	N;NOM;SG
tuska	tuska	N;NOM;SG
sorm	sorm	N;ACC;SG
luhta	luhta	N;ACC;SG
tadehkogo	tadehkogo	N;NOM;SG
huude	huude	N;NOM;SG
nagle	nagle	N;NOM;SG
kierte	kierte	N;NOM;SG
kätkyd	kätkyd	N;NOM;SG
d’äkkeri	d’äkkeri	N;NOM;SG
abie	abie	N;NOM;SG
emä	emä	N;NOM;SG
hiamait	hiamait	N;NOM;SG
rauda	rauda	N;NOM;SG
kandeleh	kandeleh	N;NOM;SG
voivalline	voivalline	ADJ;NOM;SG
seledit	seledit	N;ACC;SG
žerebii	žerebii	N;NOM;SG
regi	regi	N;ACC;SG
luukk	luukk	N;NOM;SG
adr	adr	N;ACC;SG
uks’	uks’	N;NOM;SG
kudei	kudei	N;NOM;SG
pirua	pirua	N;ACC;SG
funtte	funtte	N;NOM;SG
pajanikka	pajanikka	N;NOM;SG
korgei	korgei	ADJ;ACC;SG
viilehtus	viilehtus	N;ACC;SG
kudrit	kudrit	N;ACC;SG
groba	groba	N;ACC;SG
hibje	hibje	N;ACC;SG
virsta	virsta	N;NOM;SG
dälgaine	dälgaine	N;NOM;SG
üske	üske	N;ACC;SG
paimeta	paimendan	V;IND;SG;1;POS;PRS
Anapka	Anapka	PROPN;NOM;SG
hobje	hobje	N;ACC;SG
požarnii	požarnii	N;ACC;SG
kondicioner	kondicioner	N;ACC;SG
tahn	tahn	N;NOM;SG
igä	igä	N;ACC;SG
bor	bor	N;ACC;SG
emänd	emänd	N;ACC;SG
heltta	heltta	N;ACC;SG
stearinovoi	stearinovoi	ADJ;ACC;SG
pšeničnii	pšeničnii	ADJ;ACC;SG
Pyhädärvi	Pyhädärvi	PROPN;NOM;SG
puikko	puikko	N;NOM;SG
kumardeltakseh	kumardelemmos	V;IND;SG;1;POS;PRS
miituine	miituine	PRO;ACC;SG
kevät	kevät	N;ACC;SG
riste	riste	N;NOM;SG
kokuoi	kokuoi	N;NOM;SG
kagla	kagla	N;NOM;SG
moni	moni	PRO;ACC;SG
šiegla	šiegla	N;ACC;SG
pappi	papil	N;AT+ESS;SG
blesn	blesn	N;NOM;SG
riehtil	riehtil	N;NOM;SG
selgittädä	selgitän	V;IND;SG;1;POS;PRS
ad’v	ad’voih	N;IN+ALL;SG
höühen	höühen	N;ACC;SG
köüh	köüh	ADJ;NOM;SG
tämä	tämät	PRO;NOM;PL
muštolahd’	muštolahd’	N;ACC;SG
zautrakke	zautrakke	N;ACC;SG
podušnoi	podušnoi	N;ACC;SG
übuz	übuz	N;ACC;SG
hmel’u	hmel’u	N;NOM;SG
kaivada	kaivan	V;IND;SG;1;POS;PRS
kažid	KAŽID	N;NOM;PL
kallehembi	kallehembi	ADJ;NOM;SG
totkud	totkud	N;NOM;SG
künäbrus	künäbrus	N;ACC;SG
ruahto	ruahto	N;ACC;SG
varzi	varzi	N;ACC;SG
ombelmas	ombelmas	N;NOM;SG
veräi	veräi	N;ACC;SG
vuone	vuone	N;NOM;SG
kanave	kanave	N;ACC;SG
vuozi	vuotte	N;PRT;SG
ystävy	ystävy	N;ACC;SG
turme	turme	N;ACC;SG
suada	suan	V;IND;SG;1;POS;PRS
heimokund	heimokund	N;ACC;SG
vitilin	vitilin	N;ACC;SG
tuhmašči	tuhmašči	N;ACC;SG
tiedo	tiedo	N;ACC;SG
počč	počč	N;NOM;SG
d’uadre	d’uadre	N;NOM;SG
sirott	sirott	N;NOM;SG
zuakkon	zuakkon	N;NOM;SG
parte	parte	N;NOM;SG
viero	viero	N;NOM;SG
nel’l’kke	nel’l’kke	N;NOM;SG
mečče	mecispiä	N;IN+ABL;PL
zuakkuna	zuakkuna	N;NOM;SG
puzerta	puzerdan	V;IND;SG;1;POS;PRS
šug	šug	N;NOM;SG
hämihikkö	hämihikkö	N;NOM;SG
maime	maime	N;ACC;SG
buabo	buabo	N;ACC;SG
sieglanpiäližet	sieglanpiäližet	N;NOM;SG
karu	karu	ADJ;NOM;SG
pudr	pudr	N;NOM;SG
počiine	počiine	N;ACC;SG
stola	stola	N;ACC;SG
olgupiä	olgupiä	N;ACC;SG
sivut	sivut	N;ACC;SG
otkažida	otkažin	V;IND;SG;1;POS;PRS
les’k	les’k	N;NOM;SG
äipäi	äipäi	N;NOM;SG
neičüt	neičüt	N;ACC;SG
nevvoda	nevvon	V;IND;SG;1;POS;PRS
soime	soime	N;NOM;SG
pereloimu	pereloimu	N;NOM;SG
časoun	časoun	N;NOM;SG
karrk	karrk	N;ACC;SG
huomes	huomes	N;NOM;SG
Anus	Anus	PROPN;NOM;SG
doroganviiteh	doroganviiteh	N;ACC;SG
enzimäineargi	enzimäineargi	N;NOM;SG
suabr	suabr	N;NOM;SG
Kažinpäive	Kažinpäive	PROPN;ACC;SG
gor’a	gor’a	ADJ;ACC;SG
täyzi-igaine	täyzi-igaine	N;ACC;SG
svorc	svorc	N;ACC;SG
täpnä	täpnä	N;ACC;SG
üöläpäkk	üöläpäkk	N;ACC;SG
pirg	pirg	N;NOM;SG
šalg	šalg	N;ACC;SG
ligakuu	ligakuu	N;ACC;SG
barčč	barčč	N;ACC;SG
liedehm	liedehm	N;NOM;SG
šiemen	šiemen	N;NOM;SG
vahalaukuoi	vahalaukuoi	N;ACC;SG
kanabr	kanabr	N;ACC;SG
vojennoi	vojennoi	ADJ;ACC;SG
koivuvezi	koivuvezi	N;ACC;SG
vepsäläzed	vepsäläzed	N;NOM;SG
nähtavyys	nähtavyys	N;ACC;SG
kuudamone	kuudamone	N;ACC;SG
mečče	mecannu	N;APPRX;SG
tötkud	tötkud	N;ACC;SG
tuores	tuores	ADJ;NOM;SG
saraklinduine	saraklinduine	N;NOM;SG
kyl’mkuu	kyl’mkuu	N;ACC;SG
pert’	pert’	N;NOM;SG
tuuli	tuuli	N;ACC;SG
ondž	ondž	N;NOM;SG
virolaine	virolaine	N;NOM;SG
biibuo	biibuo	N;NOM;SG
kolmanpäiv	kolmanpäiv	N;NOM;SG
tanhut	tanhut	N;ACC;SG
pelvas	pelvas	N;NOM;SG
elände	elände	N;NOM;SG
sarai	sarai	N;NOM;SG
tavar	tavar	N;ACC;SG
astuda	emme astu	V;IND;PL;1;NEG;PRS
skuuppe	skuuppe	ADJ;NOM;SG
räččinä	räččinä	N;ACC;SG
areste	areste	N;NOM;SG
pägie	pägie	N;ACC;SG
d’ablokkepuu	d’ablokkepuu	N;ACC;SG
käbäl	käbäl	N;ACC;SG
vaguoi	vaguoi	N;NOM;SG
kuničča	kuničča	N;NOM;SG
tapant	tapant	N;ACC;SG
laučče	laučče	N;ACC;SG
päivännouzu	päivännouzu	N;ACC;SG
kero	kero	N;NOM;SG
tühdä	tühdä	ADJ;NOM;SG
pagano	pagano	ADJ;NOM;SG
nedal’	nedal’	N;NOM;SG
penger	penger	N;NOM;SG
sorz	sorz	N;NOM;SG
kaišla	kaišla	N;NOM;SG
šiibi	šiibi	N;NOM;SG
orahaižed	orahaižed	N;ACC;SG
luhte	luhte	N;NOM;SG
korpus	korpussah	N;IN+ALL;SG
vagarm	vagarm	N;ACC;SG
leykädä	leykän	V;IND;SG;1;POS;PRS
kibuntabletk	kibuntabletk	N;NOM;SG
nagl	nagl	N;NOM;SG
tuman	tuman	N;NOM;SG
talkun	talkun	N;NOM;SG
huatte	huatte	N;NOM;SG
märge	märge	N;ACC;SG
raukka	raukka	N;ACC;SG
kodinižände	kodinižände	N;ACC;SG
pard	pard	N;NOM;SG
segatavarad	segatavarad	N;ACC;SG
hotel’	hotel’	N;NOM;SG
helve	helve	N;ACC;SG
loukku	loukku	N;ACC;SG
palveilii	palveilii	N;ACC;SG
ragiž	ragiž	N;NOM;SG
kušakk	kušakk	N;ACC;SG
čuasut	čuasut	N;NOM;SG
sündünmua	sündünmua	N;NOM;SG
uulič	uulič	N;NOM;SG
suola	suola	N;NOM;SG
nižuine	nižuine	N;ACC;SG
selgerango	selgerango	N;NOM;SG
muard’ad	muard’ad	N;NOM;PL
märg	märg	N;ACC;SG
üöliluoi	üöliluoi	N;NOM;SG
puurn	puurn	N;NOM;SG
ižindäm	ižindäm	N;NOM;SG
brihačču	brihačču	N;NOM;SG
pestä	pezen	V;IND;SG;1;POS;PRS
vedehine	vedehine	N;NOM;SG
silmät	silmät	N;NOM;SG
jubke	jubke	N;NOM;SG
astuda	älgätte astugatte	V;IMP;PL;2;NEG
lühüd	lühüd	ADJ;ACC;SG
svetaine	svetaine	N;ACC;SG
kanteli	kanteli	N;NOM;SG
torgovče	torgovče	N;NOM;SG
vuas	vuas	N;ACC;SG
astuda	lienou astunu	V;PRF;POT;SG;3;POS;PRS
lähte	lähte	N;ACC;SG
kuuži	kuuži	N;ACC;SG
kuop	kuop	N;ACC;SG
trudodni	trudodn’eile	N;AT+ALL;PL
pieni	pieni	ADJ;NOM;SG
lähin	lähin	ADJ;NOM;SG
suobatte	suobatte	N;NOM;SG
tukk	tukk	N;NOM;SG
hambaz	hambaz	N;NOM;SG
kakač	kakač	N;ACC;SG
tuttav	tuttav	ADJ;ACC;SG
ombelta	ombelen	V;IND;SG;1;POS;PRS
hebommuard	hebommuard	N;ACC;SG
herre	herre	N;ACC;SG
astuda	astutanneh	V;POT;PL;3;POS;PRS
tuoreh	tuoreh	ADJ;ACC;SG
lähelline	lähelline	ADJ;NOM;SG
diädö	diädö	N;NOM;SG
karged	karged	ADJ;ACC;SG
lampadke	lampadke	N;ACC;SG
puarus	puarus	N;ACC;SG
d’augumiččd’oukko	d’augumiččd’oukko	N;ACC;SG
urok	urokal	N;AT+ESS;SG
kuorida	kuorin	V;IND;SG;1;POS;PRS
kynäbrys	kynäbrys	N;ACC;SG
dälgimaine	dälgimaine	ADJ;ACC;SG
keväz’	keväz’	N;ACC;SG
sarvi	sarvi	N;NOM;SG
mečče	mečis	N;IN+ABL;PL
külmä	külmä	ADJ;NOM;SG
tühj	tühj	ADJ;ACC;SG
muuruoi	muuruoi	N;NOM;SG
puhkuda	puhkon	V;IND;SG;1;POS;PRS
hengästyldäkseh	hengästylemmös	V;IND;SG;1;POS;PRS;REFL
palaane	palaane	N;ACC;SG
suovatta	suovatta	N;ACC;SG
lapsestuz	Lapsestusespiäi	N;IN+ABL;SG
lämm	lämm	ADJ;NOM;SG
tuatto	tuatto	N;ACC;SG
kala	kala	N;NOM;SG
voida	en voi	V;IND;SG;1;NEG;PRS
astuda	ei oldanuiš astuttu	V;PRF;COND;PL;3;NEG;PST
ar’g	ar’g	N;NOM;SG
pohkie	pohkie	N;ACC;SG
bašmakke	bašmakke	N;ACC;SG
zakona	zakona	N;ACC;SG
rikos	rikos	N;ACC;SG
haug	haug	N;ACC;SG
aršin	aršin	N;NOM;SG
muurahane	muurahane	N;NOM;SG
rebuoi	rebuoi	N;ACC;SG
hypästädäkseh	hypästimmös	V;IPFV;IND;SG;1;POS;PST;REFL
briha	briha	N;NOM;SG
lidne	lidne	N;NOM;SG
kuudaine	kuudaine	N;NOM;SG
kündüs	kündüs	N;NOM;SG
lapsed	lapsed	N;NOM;SG
päre	päre	N;NOM;SG
tina	tina	N;ACC;SG
astuda	astuu	V;IND;SG;3;POS;PRS
taivas	taivas	N;ACC;SG
kiere	kiere	N;ACC;SG
virzittaj	virzittaj	N;ACC;SG
korged	korged	ADJ;NOM;SG
lihašmötk	lihašmötk	N;ACC;SG
vualida	vualin	V;IND;SG;1;POS;PRS
sirotin	sirotin	N;ACC;SG
proklenida	proklenin	V;IND;SG;1;POS;PRS
riähk	riähk	N;NOM;SG
laihe	laihe	ADJ;ACC;SG
länge	länge	N;NOM;SG
harau	harau	N;ACC;SG
jož	jož	N;ACC;SG
kunut	kunut	N;ACC;SG
nuo	nuo	PRO;NOM;SG
d’uuri	d’uuri	N;NOM;SG
rouga	rouga	N;NOM;SG
kadomine	kadomine	N;NOM;SG
lamppe	lamppe	N;ACC;SG
virzi	virzi	N;NOM;SG
sroičče	sroičče	N;NOM;SG
kebded	kebded	ADJ;NOM;SG
napersk	napersk	N;ACC;SG
pövü	pövü	N;ACC;SG
rištižä	rištižä	N;ACC;SG
opastai	opastai	N;ACC;SG
ligo	ligo	N;ACC;SG
palgiž	palgiž	N;ACC;SG
vuara	vuara	N;ACC;SG
honga	honga	N;ACC;SG
pyhäpäi	pyhäpäi	N;ACC;SG
püššändä	püššändä	N;ACC;SG
pestäkseh	pezemmös	V;IND;SG;1;POS;PRS;REFL
ristittü	ristittü	N;NOM;SG
agja	agja	N;NOM;SG
udar	udar	N;NOM;SG
haravuoita	haravuoičen	V;IND;SG;1;POS;PRS
pärpäčč	pärpäčč	N;ACC;SG
sadul	sadul	N;NOM;SG
šüli	šüli	N;ACC;SG
puhaldus	puhaldus	N;NOM;SG
palab	palab	ADJ;NOM;SG
droškad	droškad	N;NOM;SG
peho	peho	N;NOM;SG
luari	luari	N;NOM;SG
pühäpäive	pühäpäive	N;ACC;SG
nimi	nimet	N;NOM;PL
pačas	pačas	N;ACC;SG
piätnič	piätničan	N;BYWAY;SG
kunnivo	kunnivo	N;ACC;SG
mägärä	mägärä	N;ACC;SG
ruado	ruado	N;ACC;SG
omad	oma	N;NOM;SG
birbi	birbi	N;NOM;SG
omahiine	omahiine	N;NOM;SG
hattaro	hattaro	N;NOM;SG
alužim	alužim	N;ACC;SG
kiotte	kiotte	N;NOM;SG
sotk	sotk	N;NOM;SG
čugun	čugun	N;NOM;SG
kuori	kuori	N;NOM;SG
liide	liide	N;ACC;SG
šäng	šäng	N;ACC;SG
lukoške	lukoške	N;ACC;SG
syömäri	syömäri	N;ACC;SG
vuaru	vuaru	N;ACC;SG
kukkura	kukkura	N;NOM;SG
koir	koir	N;NOM;SG
ruog	ruog	N;NOM;SG
keskimäine	keskimäine	ADJ;ACC;SG
bošak	bošak	N;NOM;SG
kurku	kurku	N;ACC;SG
piätnič	piätnič	N;ACC;SG
rega	rega	N;NOM;SG
hind	hind	N;ACC;SG
kost’urke	kost’urke	N;NOM;SG
šülü	šülü	N;NOM;SG
čiilahane	čiilahane	N;NOM;SG
emindimä	emindimä	N;ACC;SG
snuapp	snuapp	N;ACC;SG
paštuda	paštuu	V;IND;SG;3;POS;PRS
ajande	ajande	N;NOM;SG
piätn	piätn	N;NOM;SG
villaine	villaine	ADJ;ACC;SG
kandeleh	kandeleh	N;ACC;SG
kases	kases	N;NOM;SG
kezakuu	kezakuu	N;NOM;SG
tatta	tatta	N;NOM;SG
čura	čura	N;ACC;SG
muam	muam	N;ACC;SG
širme	širme	N;ACC;SG
počinpoige	počinpoige	N;ACC;SG
huab	huab	N;NOM;SG
ruozmi	ruozmi	N;ACC;SG
madeh	madeh	N;ACC;SG
pert’lomud	pert’lomud	N;NOM;SG
kobu	kobu	N;ACC;SG
pühkin	pühkin	N;NOM;SG
hond	hond	ADJ;NOM;SG
kukkur	kukkur	N;ACC;SG
merdaane	merdaane	N;ACC;SG
kätüt	kätüt	N;NOM;SG
kaivo	kaivo	N;ACC;SG
silme	silme	N;ACC;SG
korv	korv	N;NOM;SG
pšeničnii	pšeničnii	ADJ;NOM;SG
čiič	čiič	N;NOM;SG
pautin	pautin	N;NOM;SG
kokkuoi	kokkuoi	N;NOM;SG
šiib	šiib	N;NOM;SG
pogost	pogost	N;NOM;SG
žiitte	žiitte	N;NOM;SG
püü	püü	N;NOM;SG
ingermalaine	ingermalaine	ADJ;ACC;SG
külä	küläl	N;AT+ESS;SG
virši	virši	N;ACC;SG
rubl’	rubl’	N;NOM;SG
ränd	ränd	N;ACC;SG
niegl	niegl	N;NOM;SG
lepeške	lepeške	N;ACC;SG
höürü	höürü	N;ACC;SG
ongiruage	ongiruage	N;ACC;SG
opišto	opišto	N;NOM;SG
kažid	kažid	N;NOM;PL
kurikk	kurikk	N;ACC;SG
rubl’a	rubl’a	N;ACC;SG
päiv	päiv	N;ACC;SG
lumi	lumi	N;NOM;SG
kiel’	kiel’	N;NOM;SG
muju	muju	N;NOM;SG
dialekt	dialektad	N;PRT;SG
hiamai	hiamai	N;NOM;SG
siled	siled	ADJ;NOM;SG
paglad	paglad	N;NOM;SG
riste	riste	N;ACC;SG
kagla	kagla	N;ACC;SG
hajukas	hajukas	ADJ;ACC;SG
abuttada	abutti	V;IPFV;IND;SG;3;POS;PST
bumaage	bumaage	N;ACC;SG
lat’t’i	lat’t’i	N;ACC;SG
petl’	petl’	N;ACC;SG
rande	rande	N;ACC;SG
piiri	piiri	N;ACC;SG
kattoz	kattoz	N;ACC;SG
lahna	lahna	N;ACC;SG
nittädä	niitän	V;IND;SG;1;POS;PRS
ombelii	ombelii	N;NOM;SG
kilbailu	kilbailu	N;NOM;SG
ora	ora	N;NOM;SG
kunutt	kunutt	N;ACC;SG
nuaglane	nuaglane	N;ACC;SG
diplom	diplomad	N;PRT;SG
s’urtukke	s’urtukke	N;NOM;SG
halgot	halgot	N;NOM;SG
kätkyd	kätkydes	N;IN+ESS;SG
mehiene	mehiene	N;NOM;SG
köühä	köühä	ADJ;ACC;SG
šaglat	šaglat	N;NOM;SG
mado	mado	N;NOM;SG
učenikke	učenikke	N;ACC;SG
škola	škola	N;NOM;SG
pitkehände	pitkehände	N;ACC;SG
uuz	uuz	ADJ;ACC;SG
teräs	teräs	N;ACC;SG
härkkim	härkkim	N;NOM;SG
totkud	totkud	N;ACC;SG
kuutti	kuutti	N;NOM;SG
suapk	suapk	N;ACC;SG
duomuoi	duomuoi	N;ACC;SG
ruskie	ruskie	ADJ;NOM;SG
kinded	kinded	ADJ;NOM;SG
karu	karu	ADJ;ACC;SG
kieli	kieli	N;NOM;SG
vihane	vihane	ADJ;ACC;SG
pagano	pagano	ADJ;ACC;SG
šaikke	šaikke	N;NOM;SG
maidot	maidot	N;NOM;SG
viesat	viesat	N;ACC;SG
mečče	mečänny	N;BYWAY;SG
hillo	hillo	N;ACC;SG
suičed	suičed	N;ACC;SG
ombelmas	ombelmas	N;ACC;SG
bird	bird	N;NOM;SG
ardo	ardo	N;ACC;SG
mela	mela	N;ACC;SG
sukka	sukka	N;NOM;SG
vuone	vuone	N;ACC;SG
ligakkaz	ligakkaz	ADJ;ACC;SG
süöttuö	süöttuö	N;ACC;SG
kodi	kodi	N;NOM;SG
kantes	kantes	N;ACC;SG
pihke	pihke	N;NOM;SG
Brus’a	Brus’a	PROPN;NOM;SG
enzimäšargi	enzimäšargi	N;NOM;SG
VepKar - korpus	VepKar - korpus	N;NOM;SG
puol’	puol’	N;NOM;SG
čainikke	čainikke	N;NOM;SG
miidne	miidne	PRO;NOM;SG
hanhi	hanhi	N;NOM;SG
ükse	ühte	NUM;PRT;SG
ven’alaine	ven’alaine	ADJ;ACC;SG
typpitä	typpidan	V;IND;SG;1;POS;PRS
tüö	tüö	N;ACC;SG
tehnikum	tehnikum	N;ACC;SG
stuaroste	stuaroste	N;NOM;SG
pliešša	pliešša	ADJ;ACC;SG
troike	troike	N;ACC;SG
pitäččü	pitäččü	N;ACC;SG
tuah	tuah	N;NOM;SG
ainav	ainav	ADJ;ACC;SG
korbi	korbi	N;NOM;SG
liipoi	liipoi	N;NOM;SG
kohemdamiine	kohemdamiine	N;NOM;SG
taluoi	taluoiz	N;IN+ESS;SG
beda	beda	N;NOM;SG
tuores	tuores	ADJ;ACC;SG
kieletyöi	kieletyöi	ADJ;ACC;SG
pereloimu	pereloimu	N;ACC;SG
časoun	časoun	N;ACC;SG
kouriš	kouriš	N;ACC;SG
vačč	vačč	N;NOM;SG
sinun	sinun	PRO;ACC;SG
uuličče	uuličče	N;ACC;SG
palke	palke	N;NOM;SG
tietä	en tieda	V;IND;SG;1;NEG;PRS
busat	busat	N;ACC;SG
taigina	taigina	N;ACC;SG
kello	kello	N;NOM;SG
logo	logo	N;NOM;SG
urba	urba	N;NOM;SG
starin	starin	N;ACC;SG
liig	liig	ADJ;NOM;SG
lutikka	lutikka	N;NOM;SG
humbar’	humbar’	N;NOM;SG
tulda	tuli	V;IPFV;IND;SG;3;POS;PST
vauged	vauged	ADJ;NOM;SG
huomes	huomes	N;ACC;SG
jamščikke	jamščikke	N;NOM;SG
riide	riide	N;ACC;SG
voigriba	voigriba	N;NOM;SG
pošt	pošt	N;NOM;SG
mečče	mecas	N;IN+ABL;SG
kurikka	kurikka	N;ACC;SG
rygidä	rygin	V;IND;SG;1;POS;PRS
levie	levie	ADJ;ACC;SG
skuup	skuup	ADJ;ACC;SG
žadnuoi	žadnuoi	N;NOM;SG
talo	talo	N;ACC;SG
opastuskniig	opastuskniig	N;ACC;SG
vz’atke	vz’atke	N;ACC;SG
vargas	vargas	N;ACC;SG
karjalažet	karjalažet	N;NOM;SG
laude	laude	N;NOM;SG
matka	matka	N;ACC;SG
kiima	kiima	N;ACC;SG
mozgut	mozgut	N;ACC;SG
hang	hang	N;ACC;SG
raukk	raukk	N;NOM;SG
akk	akk	N;NOM;SG
kroma	kroma	N;NOM;SG
paimuoi	paimuoi	N;NOM;SG
bibliotek	bibliotek	N;NOM;SG
hago	hago	N;ACC;SG
tüö	tüö	PRO;NOM;SG
viärys	viärys	N;ACC;SG
šota	šota	N;ACC;SG
pyöryš	pyöryš	ADJ;ACC;SG
vuasse	vuasse	N;NOM;SG
hallot	hallot	N;NOM;SG
agd’	agd’	N;NOM;SG
rupč	rupč	N;ACC;SG
huude	huude	N;ACC;SG
huahlat	huahlat	N;ACC;SG
torelk	torelk	N;NOM;SG
hatrad	hatrad	N;NOM;SG
kätkyd	kätkyd	N;ACC;SG
kierte	kierte	N;ACC;SG
areste	areste	N;ACC;SG
poigindam	poigindam	N;NOM;SG
tütar	tütar	N;NOM;SG
bruusoi	bruusoi	N;NOM;SG
paiže	paiže	N;NOM;SG
kirde	kirde	N;NOM;SG
radivo	radivo	N;NOM;SG
šiibi	šiibi	N;ACC;SG
sulaimie	sulaimie	N;NOM;SG
püörie	püörie	ADJ;NOM;SG
tumeh	tumeh	N;ACC;SG
dorši	dorši	N;ACC;SG
maged	maged	ADJ;ACC;SG
puhtaz	puhtaz	ADJ;ACC;SG
korgie	korgie	ADJ;ACC;SG
härg	härg	N;ACC;SG
ruhka	ruhka	N;ACC;SG
kirvesvarzi	kirvesvarzi	N;NOM;SG
urok	urok	N;ACC;SG
appe	appe	N;ACC;SG
ježa	ježa	N;ACC;SG
nagl	nagl	N;ACC;SG
hiamii	hiamii	N;ACC;SG
tuman	tuman	N;ACC;SG
sumbe	sumbe	ADJ;NOM;SG
dügie	dügie	ADJ;ACC;SG
sygyz’	sygyz’	N;NOM;SG
mechiine	mechiine	N;ACC;SG
tuttavuda	tuttavun	V;IND;SG;1;POS;PRS
zabotte	zabotte	N;NOM;SG
mečče	mecil	N;AT+ESS;PL
hörčče	hörčče	N;ACC;SG
laute	laute	N;NOM;SG
maksande	maksande	N;NOM;SG
kedo	kedo	N;NOM;SG
kuoreh	kuoreh	N;NOM;SG
starikk	starikk	N;NOM;SG
kuvahaine	kuvahaine	N;ACC;SG
rajak	rajak	N;ACC;SG
oččetukad	oččetukad	N;ACC;SG
sappi	sappi	N;ACC;SG
piätničč	piätničč	N;NOM;SG
hüubjü	hüubjü	N;NOM;SG
lidn	lidn	N;ACC;SG
kapotta	kapotta	N;ACC;SG
žuarida	žuarin	V;IND;SG;1;POS;PRS
kalma	kalma	N;NOM;SG
silie	silie	ADJ;NOM;SG
kruug	kruug	N;NOM;SG
toisargi	toisargi	N;NOM;SG
gr’adke	gr’adke	N;ACC;SG
buole	buole	N;ACC;SG
tühje	tühje	ADJ;NOM;SG
kuuzine	kuuzine	ADJ;NOM;SG
raštau	raštau	N;NOM;SG
neičükke	neičükke	N;NOM;SG
makse	makse	N;NOM;SG
čupukke	čupukke	N;NOM;SG
mobil’nik	mobil’nik	N;NOM;SG
verko	verko	N;NOM;SG
lükkü	lükkü	N;NOM;SG
pöly	pöly	N;NOM;SG
taluoi	taluoin	N;ACC;SG
kanteli	kanteli	N;ACC;SG
teleg	teleg	N;NOM;SG
ärei	ärei	ADJ;NOM;SG
iho	iho	N;NOM;SG
sydänkeräžet	sydänkeräžet	N;NOM;SG
pert’t’	pert’t’	N;ACC;SG
kolmanžpäiv	kolmanžpäiv	N;ACC;SG
torgovče	torgovče	N;ACC;SG
jarmankad	jarmankad	N;ACC;SG
tahkadai	tahkadai	N;NOM;SG
fabrikke	fabrikke	N;NOM;SG
smieluoi	smieluoi	ADJ;ACC;SG
köyhys	köyhys	N;ACC;SG
muda	muda	N;NOM;SG
aiž	aiž	N;ACC;SG
šivut	šivut	N;NOM;SG
huodre	huodre	N;NOM;SG
käžipaikka	käžipaikka	N;ACC;SG
puraz	puraz	N;ACC;SG
muode	muode	N;NOM;SG
pedr	pedr	N;NOM;SG
ruočit	ruočit	N;NOM;SG
nellän’žapäiv	nellän’žapäiv	N;ACC;SG
verää	verää	N;NOM;SG
sumba	sumba	ADJ;ACC;SG
kanbaz	kanbaz	N;NOM;SG
zabor	zabor	N;NOM;SG
nogi	nogi	N;NOM;SG
pivo	pivo	N;NOM;SG
ärie	ärie	ADJ;ACC;SG
vladeita	vladeičen	V;IND;SG;1;POS;PRS
monid’atažihine	monid’atažihine	ADJ;NOM;SG
astuda	lienette astunu	V;PRF;POT;PL;2;POS;PRS
kiättä	kiändan	V;IND;SG;1;POS;PRS
päiväine	päiväine	N;NOM;SG
prostuudu	prostuudu	N;NOM;SG
sukke	sukke	N;NOM;SG
robeh	robeh	N;NOM;SG
mučakko	mučakko	N;NOM;SG
kolmaispäivä	kolmaispäivä	N;NOM;SG
karva	karva	N;ACC;SG
vaumiž	vaumiž	ADJ;NOM;SG
suomilažet	suomilažet	N;ACC;SG
rupp	rupp	N;NOM;SG
tiedoinikka	tiedoinikka	N;NOM;SG
kokuo	kokuo	N;NOM;SG
Kujärv	Kujärv	PROPN;ACC;SG
vaha	vaha	N;NOM;SG
sualiž	sualiž	N;ACC;SG
labie	labie	N;ACC;SG
hämihikkö	hämihikkö	N;ACC;SG
suurus	suurus	N;ACC;SG
ebävoivaine	ebävoivaine	ADJ;NOM;SG
norjalaine	norjalaine	N;NOM;SG
piene	piene	ADJ;NOM;SG
astuda	olin astunu	V;PRF;IND;SG;1;POS;PST
tihed	tihed	N;ACC;SG
blokke	blokke	N;ACC;SG
siiru	siiru	N;NOM;SG
počk	počk	N;NOM;SG
kerähmö	kerähmö	N;NOM;SG
emalambas	emalambas	N;NOM;SG
čiilak	čiilak	N;NOM;SG
kagl	kagl	N;NOM;SG
äipäi	äipäi	N;ACC;SG
lehmä	lehmä	N;NOM;SG
perzeluud	perzeluud	N;NOM;SG
kagra	kagra	N;NOM;SG
kodoilu	kodoilu	N;NOM;SG
vagava	vagava	ADJ;NOM;SG
ork	ork	N;ACC;SG
fakul’tet	fakul’tet	N;ACC;SG
ottada	ottais	V;COND;SG;3;POS;PRS
vill	vill	N;ACC;SG
tyyništuda	tyyništuin	V;IPFV;IND;SG;1;POS;PST;REFL
kuundeličču	kuundeličču	ADJ;ACC;SG
kynzi	kynded	N;NOM;PL
kaččoda	kačon	V;IND;SG;1;POS;PRS
lämmin	lämmin	ADJ;ACC;SG
ahavo	ahavo	N;ACC;SG
espanjalaine	espanjalaine	N;ACC;SG
kohtalline	kohtalline	ADJ;NOM;SG
kuccuda	kucut	V;IND;SG;2;POS;PRS
pehmei	pehmei	ADJ;NOM;SG
nedäli	nedäli	N;NOM;SG
palab	palab	ADJ;ACC;SG
ongittada	ongitan	V;IND;SG;1;POS;PRS
student	student	N;ACC;SG
selgärango	selgärango	N;ACC;SG
televizor	televizor	N;ACC;SG
sangi	sangi	N;ACC;SG
suhkol	suhkol	N;ACC;SG
garbalo	garbalo	N;ACC;SG
harakteri	harakteri	N;ACC;SG
riäpyöi	riäpyöi	N;ACC;SG
lohi	lohi	N;NOM;SG
händ	händ	N;NOM;SG
madal	madal	N;NOM;SG
kobr	kobr	N;NOM;SG
gurb	gurb	N;ACC;SG
čunkad	čunkad	N;NOM;PL
rupit	rupit	N;NOM;PL
korve	korve	N;NOM;SG
torokan	torokan	N;NOM;SG
puhaldus	puhaldus	N;ACC;SG
d’auho	d’auho	N;ACC;SG
merd	merd	N;ACC;SG
raud	raud	N;ACC;SG
grohot	grohot	N;ACC;SG
nävärgäine	nävärgäine	N;ACC;SG
kuccuda	kucun	V;IND;SG;1;POS;PRS
lipas	lipas	N;ACC;SG
kormeni	kormeni	N;NOM;SG
čekad	čekad	N;NOM;SG
bošak	bošak	N;ACC;SG
käbäläine	käbäläine	N;ACC;SG
korette	korette	N;ACC;SG
ukonkuari	ukonkuari	N;ACC;SG
velle	velle	N;ACC;SG
muzikke	muzikke	N;ACC;SG
präškä	präškä	N;ACC;SG
voimatus	voimatus	N;ACC;SG
piätn	piätn	N;ACC;SG
kuašše	kuašše	N;NOM;SG
harjus	harjus	N;ACC;SG
sera	sera	N;NOM;SG
värtinäine	värtinäine	N;NOM;SG
päive	päive	N;NOM;SG
mända	mänöv	V;IND;SG;3;POS;PRS
viuhtada	viuhtan	V;IND;SG;1;POS;PRS
tütar	tütärtte	N;PRT;SG
muuruo	muuruo	N;ACC;SG
murčukke	murčukke	N;ACC;SG
dialekt	dialektal¦gi	N;AT+ESS;SG
perä	perä	N;ACC;SG
k’aludim	k’aludim	N;NOM;SG
alašči	alašči	ADJ;NOM;SG
kydy	kydy	N;ACC;SG
lotuoi	lotuoi	N;NOM;SG
oiged	oiged	ADJ;ACC;SG
pruabuab	pruabuab	N;ACC;SG
vahalaukku	vahalaukku	N;NOM;SG
kummat	kummat	N;NOM;SG
nuot	nuot	N;NOM;SG
luukka	luukka	N;NOM;SG
pautin	pautin	N;ACC;SG
kokkuoi	kokkuoi	N;ACC;SG
vašk	vašk	N;ACC;SG
kandates	kandates	N;NOM;SG
čiič	čiič	N;ACC;SG
kopčat	kopčat	N;NOM;PL
nelläispäivä	nelläispäivä	N;ACC;SG
piilo	piilo	N;ACC;SG
vil’l’	vil’l’	N;ACC;SG
astuda	emme oliš astunu	V;PRF;COND;PL;1;NEG;PRS
üöliluoi	üöliluoi	N;ACC;SG
puurn	puurn	N;ACC;SG
brihačču	brihačču	N;ACC;SG
pordimo	pordimo	N;ACC;SG
d’uomoi	d’uomoi	N;ACC;SG
stipendii	stipendii	N;NOM;SG
riehtilä	riehtilä	N;ACC;SG
tihed	tihed	ADJ;NOM;SG
viehuri	viehuri	N;NOM;SG
ristižä	ristižä	N;ACC;SG
päčnikke	päčnikke	N;ACC;SG
porč	porč	N;NOM;SG
koht	kohtad	N;PRT;SG
oboda	oboda	N;ACC;SG
banke	banke	N;ACC;SG
kuar	kuar	N;NOM;SG
vačče	vačče	N;ACC;SG
kättüt	kättüt	N;ACC;SG
miäččü	miäččü	N;NOM;SG
šiär’	šiär’	N;ACC;SG
tamma	tamma	N;ACC;SG
koless	koless	N;NOM;SG
neižne	neižne	N;NOM;SG
perze	perze	N;NOM;SG
ounas	ounas	ADJ;NOM;SG
mehiene	mehiene	N;ACC;SG
plemännikke	plemännikke	N;ACC;SG
platform	Zoom- platformal	N;AT+ESS;SG
zirkalo	zirkalo	N;NOM;SG
pesk	pesk	N;NOM;SG
šahlut	šahlut	N;NOM;SG
halgod	halgod	N;NOM;SG
muil	muil	N;NOM;SG
nemsad	nemsad	N;NOM;SG
raštava	raštava	N;NOM;SG
raide	raide	N;ACC;SG
alužin	alužin	N;ACC;SG
ahkut	ahkut	N;ACC;SG
ruad	ruad	N;ACC;SG
kuutti	kuutti	N;ACC;SG
šein	šein	N;NOM;SG
dohtur	dohtur	N;ACC;SG
lambaz	lambaz	N;ACC;SG
diädö	diädö	N;ACC;SG
bl’uode	bl’uode	N;ACC;SG
randa	randa	N;ACC;SG
naida	nain	V;IND;SG;1;POS;PRS
škola	škola	N;ACC;SG
viikateh	viikateh	N;NOM;SG
rahkaveži	rahkaveži	N;NOM;SG
kon’aparž	kon’aparž	N;NOM;SG
nuor	nuor	N;NOM;SG
biede	biede	N;NOM;SG
veri	veri	N;NOM;SG
perže	perže	N;NOM;SG
krupnii	krupnembaz	ADJ;IN+ESS;SG
astuda	ei astunu	V;IPFV;IND;SG;3;NEG;PST
leved	leved	ADJ;ACC;SG
tagimaine	tagimaine	ADJ;ACC;SG
muuruoi	muuruoi	N;ACC;SG
ödönüöi	ödönüöi	N;NOM;SG
starin	starinal	N;AT+ESS;SG
mielduda	mieldun	V;IND;SG;1;POS;PRS
jaščikke	jaščikke	N;NOM;SG
ramba	ramba	ADJ;NOM;SG
akke	akke	N;NOM;SG
oksakas	oksakas	ADJ;ACC;SG
vuottiet	vuottiet	N;ACC;SG
poige	poige	N;ACC;SG
kalu	kalu	N;NOM;SG
ruod	ruod	N;NOM;SG
kätküd	kätküd	N;NOM;SG
mekko	mekko	N;ACC;SG
rahkiž	rahkiž	N;ACC;SG
nuagla	nuagla	N;ACC;SG
maim	maim	N;ACC;SG
puskeda	pusken	V;IND;SG;1;POS;PRS
vuakse	vuakse	N;ACC;SG
vägev	vägev	ADJ;NOM;SG
suvaita	suvaiččou	V;IND;SG;3;POS;PRS
riäpüs	riäpüs	N;ACC;SG
universitet	universitet	N;ACC;SG
hüö	hüö	PRO;NOM;SG
ouganpiä	ouganpiä	N;NOM;SG
helma	helma	N;NOM;SG
ekzamen	ekzamen	N;ACC;SG
kohemdamiine	kohemdamiine	N;ACC;SG
bošš	bošš	N;NOM;SG
blina	blina	N;NOM;SG
ruškičče	ruškičče	N;ACC;SG
suvi	suvi	N;ACC;SG
talma	talma	N;ACC;SG
ounaz	ounaz	ADJ;NOM;SG
maakondijane	maakondijane	N;NOM;SG
kurkk	kurkk	N;NOM;SG
näre	näre	N;NOM;SG
magadosia	magadosia	N;ACC;SG
imeli	imeli	N;ACC;SG
mieli	mieli	N;NOM;SG
kulak	kulak	N;ACC;SG
skuup	skuup	ADJ;NOM;SG
levie	levie	ADJ;NOM;SG
armahaine	armahaine	ADJ;NOM;SG
rokko	rokko	N;NOM;SG
ehte	ehte	N;NOM;SG
redukaz	redukaz	ADJ;ACC;SG
hieroda	hieron	V;IND;SG;1;POS;PRS
beda	beda	N;ACC;SG
opišto	opišton	N;ACC;SG
sabilahat	sabilahat	N;ACC;SG
urba	urba	N;ACC;SG
logo	logo	N;ACC;SG
zahari	zahari	N;NOM;SG
škilietta	škilietta	N;NOM;SG
kiel’	kielel	N;AT+ESS;SG
šiegl	šiegl	N;NOM;SG
keväz’kuu	keväzkuud	N;PRT;SG
d’oučen	d’oučen	N;ACC;SG
limon	limon	N;NOM;SG
vihottada	vihotan	V;IND;SG;1;POS;PRS
astuda	astuva	V.PTCP;PRS;ACT
droždit	droždit	N;NOM;PL
pual’movoi	pual’movoi	ADJ;NOM;SG
šiželihhe	šiželihhe	N;ACC;SG
hambaz	hambahiden	N;GEN;PL
šündünmua	šündünmua	N;ACC;SG
viivatiin	viivatiin	N;ACC;SG
särbädä	särbän	V;IND;SG;1;POS;PRS
libie	libie	ADJ;NOM;SG
agja	agja	N;ACC;SG
vähä	vähä	ADJ;NOM;SG
notkei	notkei	ADJ;ACC;SG
tulovišč	tulovišč	N;ACC;SG
taivaz	taivaz	N;ACC;SG
pesku	pesku	N;ACC;SG
raha	raha	N;ACC;SG
kord’a	kord’a	N;ACC;SG
vol’a	vol’a	N;ACC;SG
mollembad	mollembad	PRO;ACC;SG
kukkura	kukkura	N;ACC;SG
katus	katus	N;NOM;SG
puarus’s’a	puarus’s’a	N;ACC;SG
päivänlasku	päivänlasku	N;ACC;SG
peho	peho	N;ACC;SG
kird’aane	kird’aane	N;ACC;SG
droškad	droškad	N;ACC;SG
luari	luari	N;ACC;SG
verbl’ude	verbl’ude	N;NOM;SG
eččidä	ečin	V;IND;SG;1;POS;PRS
hatrad	hatrad	N;ACC;SG
torelk	torelk	N;ACC;SG
vaumiž	vaumiž	ADJ;ACC;SG
hirvi	hirvi	N;NOM;SG
üölevuoi	üölevuoi	N;NOM;SG
griäh	griäh	N;NOM;SG
rändä	rändä	N;ACC;SG
kirde	kirde	N;ACC;SG
radivo	radivo	N;ACC;SG
honguoi	honguoi	N;NOM;SG
laudaine	laudaine	N;ACC;SG
kul’a	kul’a	N;ACC;SG
huoneh	huoneh	N;ACC;SG
olda	on	V;IND;SG;3;POS;PRS
laihe	laihe	ADJ;NOM;SG
reppu	reppu	N;NOM;SG
böröi	böröi	N;NOM;SG
laučč	laučč	N;NOM;SG
gruzdi	gruzdi	N;NOM;SG
kauniš	kauniš	ADJ;ACC;SG
taute	taute	N;NOM;SG
abu	abu	N;ACC;SG
liuhh	liuhh	N;ACC;SG
avadin	avadin	N;NOM;SG
äippäi	äippäi	N;ACC;SG
saide	saide	N;ACC;SG
minut	minut	N;ACC;SG
šaglad	šaglad	N;ACC;SG
vepsälaine	vepsälaine	N;NOM;SG
kinttu	kinttu	N;ACC;SG
särg	särg	N;NOM;SG
halle	halle	N;NOM;SG
haude	haude	N;NOM;SG
čuassud	čuassud	N;NOM;SG
šeppä	šeppä	N;NOM;SG
mutnuoi	mutnuoi	ADJ;ACC;SG
pin’u	pin’u	N;ACC;SG
kuhlas	kuhlas	N;NOM;SG
tutkamet	tutkamet	N;NOM;SG
kirpp	kirpp	N;NOM;SG
vuoz’	vuoz’	N;ACC;SG
keühne	keühne	N;NOM;SG
šeinä	šeinä	N;NOM;SG
ärei	ärei	ADJ;ACC;SG
lambi	lambi	N;NOM;SG
valgedaine	valgedaine	N;NOM;SG
drobe	drobe	N;ACC;SG
petl’a	petl’a	N;ACC;SG
rubl’	rubl’	N;ACC;SG
opišto	opišto	N;ACC;SG
orahankarvaine	orahankarvaine	ADJ;ACC;SG
laške	laške	ADJ;ACC;SG
lange	lange	N;ACC;SG
tuagie	tuagie	ADJ;ACC;SG
ukk	ukk	N;ACC;SG
piäsküöi	piäsküöi	N;ACC;SG
lašk	lašk	ADJ;ACC;SG
lahko	lahko	N;ACC;SG
kušakko	kušakko	N;ACC;SG
kohte	kohte	N;ACC;SG
polossu	polossu	N;NOM;SG
poige	poigal	N;AT+ESS;SG
vuar	vuar	N;ACC;SG
šulkku	šulkku	N;NOM;SG
mägr	mägr	N;ACC;SG
nedäl’i	nedäl’i	N;NOM;SG
kuhn’e	kuhn’e	N;NOM;SG
armotuoi	armotuoi	N;ACC;SG
elaige	ELAIGAS	N;IN+ESS;SG
puukka	puukka	N;ACC;SG
ubar	ubar	N;ACC;SG
nuott	nuott	N;ACC;SG
kannates	kannates	N;NOM;SG
mindali	mindali	N;NOM;SG
pilkeh	pilkeh	N;NOM;SG
käzipaik	käzipaik	N;ACC;SG
luzikka	luzikka	N;NOM;SG
uzohtin	uzohtin	N;ACC;SG
huabe	huabe	N;NOM;SG
broni	broni	N;ACC;SG
čihlane	čihlane	N;ACC;SG
syli	syli	N;ACC;SG
strela	strela	N;ACC;SG
voine	voine	N;NOM;SG
eläda	elän	V;IND;SG;1;POS;PRS
kilometr	kilometrit	N;PRT;SG
viertä	vierdän	V;IND;SG;1;POS;PRS
itkedä	itken	V;IND;SG;1;POS;PRS
sinižömä	sinižömä	N;NOM;SG
lähtedä	lähten	V;IND;SG;1;POS;PRS
pikkaraane	pikkaraane	ADJ;ACC;SG
onzi	onzi	N;NOM;SG
mado	mado	N;ACC;SG
gorgottada	gorgotan	V;IND;SG;1;POS;PRS
iäni	iäni	N;NOM;SG
verkkomiäčč	verkkomiäčč	N;ACC;SG
orava	orava	N;ACC;SG
hiillos	hiillos	N;ACC;SG
Pyhädärvi	Pyhädärvehe	PROPN;IN+ALL;SG
haravo	haravo	N;NOM;SG
rodu	rodu	N;NOM;SG
prostuudu	prostuudu	N;ACC;SG
neče	neče	PRO;ACC;SG
huol’	huolte	N;PRT;SG
syvä	syvä	N;ACC;SG
d’yged	d’yged	ADJ;ACC;SG
robeh	robeh	N;ACC;SG
mučakko	mučakko	N;ACC;SG
vel’l’i	vel’l’i	N;NOM;SG
povi	povi	N;NOM;SG
meččekana	meččekana	N;ACC;SG
tämä	täkse	PRO;TRANS;SG
kando	kando	N;NOM;SG
dorog	dorogah	N;IN+ALL;SG
rotte	rotte	N;NOM;SG
muzav	muzav	ADJ;ACC;SG
viesti	viesti	N;NOM;SG
riäd	riäd	N;NOM;SG
lukku	lukku	N;NOM;SG
kuavi	kuavi	N;ACC;SG
tahne	tahne	N;ACC;SG
sulhaine	sulhaine	N;NOM;SG
typä	typä	N;NOM;SG
lainiž	lainiž	N;ACC;SG
kouhkot	kouhkot	N;ACC;SG
näpp	näpp	N;ACC;SG
kohtune	kohtune	ADJ;NOM;SG
puhtas	puhtas	ADJ;ACC;SG
pimei	pimei	ADJ;ACC;SG
ruahka	ruahka	ADJ;NOM;SG
pruaznik	pruaznik	N;NOM;SG
mavruoi	mavruoi	N;NOM;SG
lizä	lizä	N;NOM;SG
astuda	oldaiš astuttu	V;PRF;COND;PL;3;POS;PRS
professii	professii	N;NOM;SG
vozduhe	vozduhe	N;NOM;SG
borčče	borčas	N;IN+ESS;SG
počk	počk	N;ACC;SG
kerähmö	kerähmö	N;ACC;SG
čiilak	čiilak	N;ACC;SG
emalambas	emalambas	N;ACC;SG
pidädä	pidetäh	V;IND;PL;3;POS;PRS
patente	patente	N;ACC;SG
tahtoda	tahtuoižin	V;COND;SG;1;POS;PRS
tačm	tačm	N;ACC;SG
kurs	Kursiil	N;AT+ESS;PL
kurs	kursad	N;NOM;PL
uuz	uuz	ADJ;NOM;SG
topp	topp	N;NOM;SG
täiz’	täiz’	N;NOM;SG
habukk	habukk	N;NOM;SG
agje	agje	N;NOM;SG
hän	hän	PRO;ACC;SG
ruskie	ruskie	ADJ;ACC;SG
fatieru	fatieru	N;NOM;SG
ragendo	ragendo	N;NOM;SG
humbar’	humbar’	N;ACC;SG
lutikka	lutikka	N;ACC;SG
kofei	kofei	N;ACC;SG
kagra	kagra	N;ACC;SG
käzipaikke	käzipaikke	N;ACC;SG
kodoilu	kodoilu	N;ACC;SG
neveske	neveske	N;ACC;SG
busad	busad	N;ACC;SG
kegäleh	kegäleh	N;NOM;SG
keraažet	keraažet	N;NOM;SG
astuda	emme olnuiš astunu	V;PRF;COND;PL;1;NEG;PST
poiga	poiga	N;ACC;SG
vaski	vaski	N;NOM;SG
nedäl	nedäl	N;NOM;SG
astuda	ette olnuiš astunu	V;PRF;COND;PL;2;NEG;PST
t’otka	t’otkad	N;NOM;PL
zale	zale	N;NOM;SG
piirai	piirai	N;ACC;SG
sulaim	sulaim	N;NOM;SG
tammi	tammi	N;NOM;SG
tuuč	tuuč	N;ACC;SG
karžut	karžut	N;ACC;SG
huršti	huršti	N;NOM;SG
levei	levei	ADJ;NOM;SG
viškain	viškain	N;NOM;SG
selgepii	selgepii	N;NOM;SG
ongiruag	ongiruag	N;ACC;SG
halla	halla	N;ACC;SG
vepsäd	vepsäd	N;NOM;SG
mal’l’aane	mal’l’aane	N;NOM;SG
paarussu	paarussu	N;ACC;SG
varzaine	varzaine	N;ACC;SG
randu	randu	N;ACC;SG
vunukko	vunukko	N;ACC;SG
brod’age	brod’age	N;NOM;SG
ižand	ižand	N;ACC;SG
karjalažet	karjalažet	N;ACC;SG
vahnembat	vahnembat	N;NOM;SG
lidn	lidnah	N;IN+ALL;SG
aiža	aiža	N;NOM;SG
kauhe	kauhe	N;ACC;SG
vävü	vävü	N;NOM;SG
vuapsahaine	vuapsahaine	N;NOM;SG
hištorijahine	hištorijahine	ADJ;NOM;SG
muigei	muigei	ADJ;NOM;SG
kondu	kondu	N;ACC;SG
durakke	durakke	N;NOM;SG
ripakk	ripakk	N;ACC;SG
d’yömine	d’yömine	N;ACC;SG
mietke	mietke	N;ACC;SG
kengidä	kengin	V;IND;SG;1;POS;PRS
alašči	alašči	ADJ;ACC;SG
VepKar	VepKar	PROPN;ACC;SG
meččuoi	meččuoi	N;NOM;SG
lago	lago	N;ACC;SG
huba	huba	ADJ;NOM;SG
t’yuni	t’yuni	ADJ;ACC;SG
taut	taut	N;ACC;SG
programme	programmad	N;PRT;SG
voin	voin	N;ACC;SG
toineargi	toineargi	N;ACC;SG
päičet	päičet	N;ACC;SG
ruode	ruode	N;ACC;SG
polttajaane	polttajaane	N;NOM;SG
žesti	žesti	N;NOM;SG
hamar	hamar	N;NOM;SG
piili	piili	N;NOM;SG
siegl	siegl	N;NOM;SG
želtuuha	želtuuha	N;NOM;SG
karku	karku	N;NOM;SG
kuzimuuruoi	kuzimuuruoi	N;NOM;SG
mieletyöi	mieletyöi	ADJ;NOM;SG
käbälä	käbälä	N;NOM;SG
bes’otk	bes’otk	N;NOM;SG
tuhukuu	tuhukuu	N;NOM;SG
astuda	oližin astunu	V;PRF;COND;SG;1;POS;PRS
čiidalo	čiidalo	N;NOM;SG
moni	monet	PRO;NOM;PL
kangas	kangas	N;NOM;SG
miä	miä	PRO;ACC;SG
remeni	remeni	N;NOM;SG
podarida	podarin	V;IND;SG;1;POS;PRS
izo	izo	ADJ;NOM;SG
sihlik	sihlik	N;NOM;SG
tekst	tekstad	N;NOM;PL
spuaru	spuaru	N;ACC;SG
varoi	varoi	N;ACC;SG
skluad	skluaduu	N;IN+ALL;SG
p’atna	p’atna	N;NOM;SG
knige	knige	N;ACC;SG
leva	leva	N;ACC;SG
bahalauk	bahalauk	N;ACC;SG
internuot	internuot	N;ACC;SG
sija	sijah	N;IN+ALL;SG
t’ädi	t’ädi	N;ACC;SG
möükkü	möükkü	N;NOM;SG
pühkim	pühkim	N;NOM;SG
ogorod	ogorod	N;NOM;SG
piäskuohut	piäskuohut	N;NOM;SG
biraine	biraine	N;NOM;SG
köüh	köüh	ADJ;ACC;SG
zavalin	zavalin	N;ACC;SG
urokk	urokk	N;ACC;SG
barbe	barbe	N;NOM;SG
stipendii	stipendii	N;ACC;SG
podval	podval	N;NOM;SG
marke	marke	N;NOM;SG
mečče	mečätä	N;PRIV;SG
nodrei	nodrei	ADJ;NOM;SG
saduli	saduli	N;ACC;SG
očče	očče	N;ACC;SG
ukrainalaine	ukrainalaine	N;ACC;SG
zabor	zabor	N;ACC;SG
ozra	ozra	N;NOM;SG
vannaz	vannaz	N;NOM;SG
podušnoi	podušnoi	N;NOM;SG
zautrakke	zautrakke	N;NOM;SG
habuk	habuk	N;ACC;SG
pordimoi	pordimoi	N;ACC;SG
biegluoi	biegluoit	N;NOM;PL
hörč	hörč	N;NOM;SG
kävyda	kävüimme	V;IPFV;IND;PL;1;POS;PST
üöččim	üöččim	N;NOM;SG
ajandahine	ajandahine	N;NOM;SG
vastata	vastadan	V;IND;SG;1;POS;PRS
liipak	liipak	N;ACC;SG
luadon’	luadon’	N;ACC;SG
tovarat	tovarat	N;ACC;SG
miäččü	miäččü	N;ACC;SG
rungo	rungo	N;ACC;SG
varzi	varzi	N;NOM;SG
vuottada	vuotan	V;IND;SG;1;POS;PRS
opitelta	opittelen	V;IND;SG;1;POS;PRS
vaumis	vaumis	ADJ;ACC;SG
šein	šein	N;ACC;SG
nahk	nahk	N;ACC;SG
rehto	rehto	N;NOM;SG
karjalad	karjalad	N;ACC;SG
rist	rist	N;ACC;SG
kangaz	kangaz	N;NOM;SG
škol	škol	N;ACC;SG
pappi	pappih	N;IN+ALL;SG
ložme	ložme	N;NOM;SG
koire	koire	N;NOM;SG
pii	pii	N;NOM;SG
fakul’tet	fakul’tetan	N;ACC;SG
Natoi	Natoi	PROPN;NOM;SG
uzle	uzle	N;ACC;SG
kuokke	kuokke	N;ACC;SG
vero	vero	N;ACC;SG
rihme	rihme	N;ACC;SG
johtai	johtai	N;NOM;SG
märg	märg	ADJ;ACC;SG
niemukke	niemukke	N;ACC;SG
syödä	syön	V;IND;SG;1;POS;PRS
ezmažarg	ezmažarg	N;ACC;SG
mie	mie	PRO;NOM;SG
rupp	rupp	N;ACC;SG
suomelaižet	suomelaižet	N;NOM;SG
ižännimi	ižännimi	N;NOM;SG
kokuo	kokuo	N;ACC;SG
tiedäi	tiedäi	N;NOM;SG
laut	laut	N;ACC;SG
äijäpäivä	äijäpäivä	N;NOM;SG
kupče	kupče	N;ACC;SG
laučča	laučča	N;NOM;SG
yliopišto	yliopišto	N;NOM;SG
nit’	nit’	N;NOM;SG
piihted	piihted	N;NOM;PL
maikku	maikku	N;NOM;SG
muattada	muatan	V;IND;SG;1;POS;PRS
halgo	halgo	N;NOM;SG
ongi	ongi	N;ACC;SG
rooga	rooga	N;ACC;SG
mieli	mieli	N;ACC;SG
näre	näre	N;ACC;SG
värttinä	värttinä	N;NOM;SG
šittebörüöi	šittebörüöi	N;NOM;SG
kunna	kunna	PRO;ACC;SG
aštiet	aštiet	N;NOM;SG
blina	blina	N;ACC;SG
šügüz	šügüz	N;ACC;SG
ligakuu	ligakuu	N;NOM;SG
hoikke	hoikke	ADJ;NOM;SG
lauda	lauda	N;ACC;SG
kurki	kurki	N;ACC;SG
rujod	rujod	N;ACC;SG
truba	truba	N;ACC;SG
lähtem	lähtem	N;NOM;SG
lagi	lagi	N;NOM;SG
rungas	rungas	N;NOM;SG
iče	iče	PRO;ACC;SG
kezakodi	kezakodi	N;NOM;SG
pruaznikka	pruaznikka	N;ACC;SG
peittädä	peitän	V;IND;SG;1;POS;PRS
koivuine	koivuine	ADJ;ACC;SG
astuda	ette astunuiš	V;IPFV;COND;PL;2;NEG;PST
mužikke	mužikke	N;ACC;SG
nerähe	nerähe	N;ACC;SG
ebävoivaine	ebävoivaine	ADJ;ACC;SG
mir	mir	N;ACC;SG
rištuoi	rištuoi	N;ACC;SG
sarga	sarga	N;ACC;SG
sia	sia	PRO;NOM;SG
ajoš	ajoš	N;NOM;SG
kunič	kunič	N;NOM;SG
kravat’t’i	kravat’t’i	N;ACC;SG
korve	korve	N;ACC;SG
kobr	kobr	N;ACC;SG
gr’yhe	gr’yhe	N;ACC;SG
pistolette	pistolette	N;ACC;SG
sorm	sorm	N;NOM;SG
meži	meži	N;NOM;SG
ristikanze	ristikanze	N;NOM;SG
d’yged	d’yged	ADJ;NOM;SG
liikuttada	liikutan	V;IND;SG;1;POS;PRS
käžipaikk	käžipaikk	N;NOM;SG
paltina	paltina	N;NOM;SG
syndymmua	syndymmua	N;NOM;SG
toukke	toukke	N;NOM;SG
liuhtes	liuhtes	N;NOM;SG
rohkei	rohkei	ADJ;ACC;SG
laud	laud	N;NOM;SG
kaššali	kaššali	N;ACC;SG
sizär	sizär	N;ACC;SG
keli	keli	N;ACC;SG
üö	üö	N;ACC;SG
hebo	hebo	N;ACC;SG
d’yrišta	d’yrižen	V;IND;SG;1;POS;PRS
nenätyöi	nenätyöi	ADJ;ACC;SG
šinä	šinä	PRO;NOM;SG
kukkar	kukkar	N;ACC;SG
miehe	miehe	N;ACC;SG
šitta	šitta	N;ACC;SG
d’allačče	d’allačče	N;ACC;SG
mägre	mägre	N;ACC;SG
sus’s’od	sus’s’od	N;ACC;SG
sebä	sebä	N;ACC;SG
mügrä	mügrä	N;NOM;SG
riido	riido	N;ACC;SG
tahnuo	tahnuo	N;ACC;SG
härgä	härgä	N;ACC;SG
riähke	riähke	N;NOM;SG
kymmenike	kymmenike	N;NOM;SG
luaskave	luaskave	ADJ;NOM;SG
ruahtomaido	ruahtomaido	N;ACC;SG
viilehtus	viilehtus	N;NOM;SG
nerve	nerve	N;ACC;SG
olgi	olgi	N;ACC;SG
kyrze	kyrze	N;ACC;SG
požarnii	požarnii	N;NOM;SG
kondicioner	kondicioner	N;NOM;SG
Simaništo	Simaništo	PROPN;NOM;SG
riähkä	riähkä	N;NOM;SG
licei	licejiin	N;GEN;PL
čerkkou	čerkkou	N;ACC;SG
kündüz	kündüz	N;ACC;SG
abiduita	abidoičen	V;IND;SG;1;POS;PRS
häi	hänell	PRO;AT+ESS;SG
rahka	rahka	N;NOM;SG
šeinä	šeinä	N;ACC;SG
Saksa	Saksa	PROPN;NOM;SG
starin	starinad	N;NOM;PL
märg	märg	N;NOM;SG
gniede	gniede	ADJ;NOM;SG
tožar’g’	tožar’g’	N;NOM;SG
kierd	kierdan	N;FRML;SG
muurahaine	muurahaine	N;ACC;SG
žalob	žaloban	N;ACC;SG
orih	orih	N;NOM;SG
sugunimi	sugunimi	N;ACC;SG
peipuone	peipuone	N;ACC;SG
pyöry	pyöry	N;ACC;SG
häin	häin	PRO;ACC;SG
dialekt	dialekt	N;NOM;SG
astuda	ette ole astunu	V;PRF;IND;PL;2;NEG;PRS
märgä	märgä	ADJ;NOM;SG
torelke	torelke	N;ACC;SG
ruoga	ruoga	N;ACC;SG
kokačču	kokačču	N;ACC;SG
d’auh	d’auh	N;ACC;SG
lyöda	lyön	V;IND;SG;1;POS;PRS
tahk	tahk	N;NOM;SG
bemböl	bemböl	N;NOM;SG
stantsii	stantsii	N;NOM;SG
kulde	kulde	N;NOM;SG
vačča	vačča	N;NOM;SG
pitkähändä	pitkähändä	N;ACC;SG
sinižömä	sinižömä	N;ACC;SG
kudakui	kudakui	PRO;ACC;SG
surm	surm	N;ACC;SG
haravo	haravo	N;ACC;SG
rodu	rodu	N;ACC;SG
šiželihkö	šiželihkö	N;NOM;SG
käzirüüstä	käzirüüstä	N;ACC;SG
torgu	torgu	N;ACC;SG
anop	anop	N;NOM;SG
kird’a	kird’a	N;ACC;SG
čirpi	čirpi	N;ACC;SG
tuhmašči	tuhmašči	N;NOM;SG
dyged	dyged	ADJ;ACC;SG
tiedo	tiedo	N;NOM;SG
uško	uško	N;NOM;SG
čurk	čurk	N;ACC;SG
eräs	eräs	PRO;ACC;SG
kuuzi	kuuzi	N;NOM;SG
paha	paha	ADJ;ACC;SG
talvi	talvi	N;ACC;SG
külä	külä	N;ACC;SG
kalaine	kalaine	N;ACC;SG
maido	maido	N;ACC;SG
d’algaččet	d’algaččet	N;ACC;SG
tyhje	tyhje	N;ACC;SG
labaz	labaz	N;ACC;SG
kando	kando	N;ACC;SG
kohalline	kohalline	ADJ;NOM;SG
südämkeräižet	südämkeräižet	N;ACC;SG
kulme	kulme	N;NOM;SG
karjalaižed	karjalaižed	N;NOM;SG
tutkaimet	tutkaimet	N;ACC;SG
nuora	nuora	N;ACC;SG
prikol’enii	prikol’enii	N;ACC;SG
kulakke	kulakke	N;ACC;SG
hudra	hudra	ADJ;NOM;SG
riščiža	riščiža	N;NOM;SG
muatuška	muatuška	N;ACC;SG
kiändai	kiändai	N;ACC;SG
ouganpiä	ouganpiä	N;ACC;SG
helma	helma	N;ACC;SG
muste	muste	ADJ;NOM;SG
sulhaine	sulhaine	N;ACC;SG
typä	typä	N;ACC;SG
kalalokka	kalalokka	N;ACC;SG
kard’alaine	kard’alaižed	N;NOM;PL
sana	sana	N;NOM;SG
rokko	rokko	N;ACC;SG
ehte	ehte	N;ACC;SG
hambas	hambas	N;NOM;SG
koditoi	kodittomad	ADJ;NOM;PL
keväz’	kevädel	N;AT+ESS;SG
kibuhiine	kibuhiine	ADJ;NOM;SG
hill	hill	N;NOM;SG
pouda	pouda	N;ACC;SG
ragendo	ragendo	N;ACC;SG
obbeita	obbeičen	V;IND;SG;1;POS;PRS
pereh	perehes	N;IN+ABL;SG
viin	viin	N;NOM;SG
koivuvezi	koivuvezi	N;NOM;SG
časoune	časoune	N;ACC;SG
tadeh	tadeh	N;ACC;SG
hyppidä	hypii	V;IPFV;IND;SG;3;POS;PST
univermag	univermagas	N;IN+ESS;SG
ykssilme	ykssilme	ADJ;ACC;SG
burakk	burakk	N;ACC;SG
čihkuoi	čihkuoi	N;ACC;SG
vederiste	vederiste	N;ACC;SG
astuda	et olnuiš astunu	V;PRF;COND;SG;2;NEG;PST
čieppi	čieppi	N;ACC;SG
spora	spora	N;NOM;SG
čiučuoi	čiučuoi	N;NOM;SG
barbik	barbik	N;NOM;SG
vezihiiri	vezihiiri	N;NOM;SG
suapkad	suapkad	N;NOM;SG
ville	ville	N;ACC;SG
liettä	lienov	V;IND;SG;3;POS;PRS
orav	orav	N;NOM;SG
lauč	lauč	N;NOM;SG
präške	präške	N;ACC;SG
butilke	butilke	N;NOM;SG
ščokad	ščokad	N;NOM;SG
kanza	kanza	N;NOM;SG
mehäine	mehäine	N;NOM;SG
greče	greče	N;NOM;SG
tuomi	tuomi	N;NOM;SG
tavar	tavar	N;NOM;SG
püššändä	püššändä	N;NOM;SG
sorze	sorze	N;NOM;SG
minä	minukši	PRO;TRANS;SG
biibal’	biibal’	N;ACC;SG
sier	sier	N;ACC;SG
hyväroduine	hyväroduine	ADJ;ACC;SG
piä	piä	ADJ;ACC;SG
goste	goste	N;NOM;SG
pičukuine	pičukuine	ADJ;NOM;SG
vaivuda	vaivun	V;IND;SG;1;POS;PRS
vajehtada	vajehtan	V;IND;SG;1;POS;PRS
d’ablokkepuu	d’ablokkepuu	N;NOM;SG
käbäl	käbäl	N;NOM;SG
korvatyvi	korvatyvi	N;NOM;SG
hapannu	hapannu	ADJ;ACC;SG
ailahat	ailahat	N;ACC;SG
keväz’kuu	keväz’kuu	N;ACC;SG
südänkerät	südänkerät	N;ACC;SG
talkkun	talkkun	N;ACC;SG
opastund	opastund	N;NOM;SG
suoni	suoni	N;NOM;SG
bembelö	bembelö	N;ACC;SG
tsari	tsari	N;ACC;SG
astuda	astunuižimme	V;IPFV;COND;PL;1;POS;PST
tukkunaine	tukkunaine	ADJ;NOM;SG
havad	havad	N;ACC;SG
piätnič	piätnič	N;NOM;SG
udaluoi	udaluoi	ADJ;NOM;SG
čoma	čoma	ADJ;NOM;SG
vilu	vilu	ADJ;ACC;SG
lehmuz	lehmuz	N;ACC;SG
čaaju	čaaju	N;ACC;SG
šiima	šiima	N;ACC;SG
suad’bo	suad’bo	N;ACC;SG
n’ustada	n’ustan	V;IND;SG;1;POS;PRS
kobu	kobu	N;NOM;SG
adress	adress	N;NOM;SG
haumeh	haumeh	N;NOM;SG
äjäpäiv	äjäpäiv	N;NOM;SG
loukko	loukko	N;NOM;SG
uwtates	uwtates	N;NOM;SG
rambita	rambičen	V;IND;SG;1;POS;PRS
svetaane	svetaane	N;NOM;SG
meččuoi	meččuoi	N;ACC;SG
huudeh	huudeh	N;NOM;SG
rubilöttö	rubilöttö	N;NOM;SG
želtuuha	želtuuha	N;ACC;SG
šurd’ak	šurd’ak	N;ACC;SG
kuoppa	kuoppa	N;ACC;SG
huahmuoi	huahmuoi	ADJ;ACC;SG
siäriluu	siäriluu	N;NOM;SG
brusakka	brusakka	N;ACC;SG
puhuda	puhun	V;IND;SG;1;POS;PRS
brujad	brujad	N;NOM;SG
krupnii	krupnii	ADJ;ACC;SG
kehnone	kehnone	ADJ;ACC;SG
lomud	lomud	N;ACC;SG
heine	heine	N;ACC;SG
malle	malle	N;ACC;SG
ven’al’ažet	ven’al’ažet	N;NOM;SG
liina	liina	N;ACC;SG
riida	riida	N;ACC;SG
kird’aine	kird’aine	N;NOM;SG
babarm	babarm	N;NOM;SG
kangas	kangas	N;ACC;SG
sugu	sugu	N;ACC;SG
vagav	vagav	ADJ;NOM;SG
kebded	kebded	ADJ;ACC;SG
vuas	vuas	N;NOM;SG
lähte	lähte	N;NOM;SG
kuuži	kuuži	N;NOM;SG
rodindpäiv	rodindpäiv	PROPN;NOM;SG
tahtas	tahtas	N;ACC;SG
eziine	eziine	ADJ;ACC;SG
uhku	uhku	N;NOM;SG
zautrokka	zautrokka	N;ACC;SG
silme	silmiih	N;IN+ALL;PL
laškuz	laškuz	N;NOM;SG
muamo	muamo	N;NOM;SG
rodindpäiv	rodindpäiv	PROPN;ACC;SG
kolakka	kolakka	N;ACC;SG
drožžit	drožžit	N;ACC;SG
muu	muu	ADJ;NOM;SG
mielikaz	mielikaz	ADJ;ACC;SG
vaumis	vaumis	ADJ;NOM;SG
žiželi	žiželi	N;ACC;SG
laihina	laihina	N;NOM;SG
rohkie	rohkie	ADJ;ACC;SG
meckana	meckana	N;ACC;SG
rištata	rištata	N;NOM;SG
viržittäjä	viržittäjä	N;NOM;SG
pitkehände	pitkehände	N;NOM;SG
kynäbrys	kynäbrys	N;NOM;SG
olda	ei oldaiš	V;COND;PL;3;NEG;PRS
vihuri	vihuri	N;NOM;SG
taloi	talois	N;IN+ESS;SG
kivos	kivos	N;NOM;SG
üöččim	üöččim	N;ACC;SG
harag	harag	N;NOM;SG
mel’ničče	mel’ničče	N;ACC;SG
tervehyz	tervhytt	N;PRT;SG
liipuoi	liipuoi	N;ACC;SG
parh	parh	N;ACC;SG
oug	oug	N;ACC;SG
šuapka	šuapka	N;ACC;SG
vuass	vuass	N;ACC;SG
muzava	muzava	ADJ;NOM;SG
sorminahk	sorminahk	N;NOM;SG
naba	naba	N;NOM;SG
ingermalaine	ingermalaine	ADJ;NOM;SG
hinde	hinde	N;ACC;SG
lötöt	lötöt	N;ACC;SG
leibe	leibe	N;NOM;SG
lämmö	lämmö	N;ACC;SG
sotke	sotke	N;ACC;SG
iga	iga	N;ACC;SG
minä	minä	PRO;ACC;SG
haiker	haiker	N;ACC;SG
šängi	šängi	N;NOM;SG
ehtidä	ehtin	V;IND;SG;1;POS;PRS
vozduhe	vozduhe	N;ACC;SG
Riga	Riga	PROPN;NOM;SG
niegle	niegle	N;ACC;SG
puaksu	puaksu	ADJ;NOM;SG
starin	starin	N;NOM;SG
hiilavu	hiilavu	ADJ;NOM;SG
suug	suug	N;NOM;SG
rebo	rebo	N;ACC;SG
uuličče	uuličče	N;NOM;SG
mečč	mečč	N;ACC;SG
täiz’	täiz’	N;ACC;SG
habukk	habukk	N;ACC;SG
kouriš	kouriš	N;NOM;SG
agje	agje	N;ACC;SG
d’ävidäkseh	d’ävimmös	V;IND;SG;1;POS;PRS;REFL
parži	parži	N;ACC;SG
busat	busat	N;NOM;SG
taigina	taigina	N;NOM;SG
Kard’al	Kard’al	PROPN;NOM;SG
värttinä	värttinä	N;ACC;SG
lugend	lugend	N;ACC;SG
karassin	karassin	N;NOM;SG
čugu	čugu	N;NOM;SG
hibie	hibie	N;NOM;SG
keskmaane	keskmaane	ADJ;ACC;SG
virzittaj	virzittaj	N;NOM;SG
turb	turb	N;ACC;SG
hangi	hangi	N;ACC;SG
loppu	loppu	N;NOM;SG
kaski	kaski	N;NOM;SG
uuži	uuži	ADJ;ACC;SG
tagaine	tagaine	ADJ;NOM;SG
žerebii	žerebii	N;ACC;SG
murčukka	murčukka	N;NOM;SG
vaski	vaski	N;ACC;SG
vargas	vargas	N;NOM;SG
opastuskniig	opastuskniig	N;NOM;SG
uhkerdus	uhkerdus	N;NOM;SG
talo	talo	N;NOM;SG
rambe	rambe	ADJ;NOM;SG
veza	veza	N;ACC;SG
syömäri	syömäri	N;NOM;SG
kezuoi	kezuoi	N;NOM;SG
kosič	kosič	N;ACC;SG
koditoi	kodittoman	ADJ;GEN;SG
skuupp	skuupp	ADJ;NOM;SG
täüziigäine	täüziigäine	ADJ;NOM;SG
ruado	ruado	N;NOM;SG
mägärä	mägärä	N;NOM;SG
kunnivo	kunnivo	N;NOM;SG
kylmädä	kylmän	V;IND;SG;1;POS;PRS
viškain	viškain	N;ACC;SG
sauvva	sauvva	N;NOM;SG
kukuoinkuari	kukuoinkuari	N;NOM;SG
ven’alaine	ven’alaine	ADJ;NOM;SG
astuda	olitte astunu	V;PRF;IND;PL;2;POS;PST
afstriiskuoi	afstriiskuoile	ADJ;AT+ALL;SG
anket	anket	N;ACC;SG
moru	moru	N;NOM;SG
giire	giire	N;NOM;SG
murgina	murgina	N;NOM;SG
katke	katke	N;NOM;SG
kirikkö	kirikkö	N;NOM;SG
kird’	kird’	N;NOM;SG
vandeh	vandeh	N;NOM;SG
muamindam	muamindam	N;ACC;SG
leivät	leivät	N;NOM;SG
sisär	sisär	N;NOM;SG
lehme	lehmidh	N;IN+ALL;PL
häkki	häkki	N;NOM;SG
keppi	keppi	N;NOM;SG
veži	veži	N;NOM;SG
köühnä	köühnä	N;ACC;SG
tahn	tahn	N;ACC;SG
sizär	sizäred	N;NOM;PL
maimekala	maimekala	N;NOM;SG
vuož	vuož	N;NOM;SG
kibuhine	kibuhine	ADJ;NOM;SG
värnik	värnik	ADJ;NOM;SG
pada	pada	N;NOM;SG
vuona	vuona	N;ACC;SG
piihtet	piihtet	N;NOM;SG
naperska	naperska	N;NOM;SG
salvo	salvo	N;NOM;SG
toppa	toppa	N;NOM;SG
astuda	en ole astunu	V;PRF;IND;SG;1;NEG;PRS
mučuoi	mučuoi	N;NOM;SG
blesn	blesn	N;ACC;SG
lavat	lavat	N;ACC;SG
gluhuoi	gluhuoi	ADJ;NOM;SG
tuttav	tuttav	ADJ;NOM;SG
küünäspiä	küünäspiä	N;NOM;SG
ruda	ruda	N;NOM;SG
omblii	omblii	N;NOM;SG
tožnarg	tožnarg	N;NOM;SG
üölie	üölie	N;NOM;SG
hura	hura	ADJ;ACC;SG
vast	vast	N;ACC;SG
paida	paida	N;ACC;SG
čaju	čaju	N;ACC;SG
pohd’aine	pohd’aine	N;NOM;SG
lepeške	lepeške	N;NOM;SG
höürü	höürü	N;NOM;SG
m’ačkaida	m’ačkain	V;IND;SG;1;POS;PRS
huondes	huondes	N;ACC;SG
kengätombelii	kengätombelii	N;NOM;SG
vuatte	vuatte	N;NOM;SG
vaskine	vaskine	N;NOM;SG
sulakuu	sulakuu	N;NOM;SG
räkke	räkke	N;NOM;SG
panda	panen	V;IND;SG;1;POS;PRS
luka	luka	N;NOM;SG
kamod	kamod	N;NOM;SG
pulluone	pulluone	N;ACC;SG
riähkä	riähkä	N;ACC;SG
vidin	vidin	N;ACC;SG
kanabro	kanabro	N;NOM;SG
selguine	selguine	N;ACC;SG
bul’kada	bul’kau	V;IND;SG;1;POS;PRS
halmeh	halmeh	N;ACC;SG
roditel’ad	roditel’ad	N;NOM;PL
sevuoitar	sevuoitar	N;ACC;SG
kymmenike	kymmenike	N;ACC;SG
riähke	riähke	N;ACC;SG
astuda	astuttu	V.PTCP;PST;PASS
rodu	rodut	N;PRT;SG
linna	linna	N;NOM;SG
vaikku	vaikku	N;ACC;SG
pordimuoi	pordimuoi	N;ACC;SG
pippuri	pippuri	N;ACC;SG
nelläšpäiv	nelläšpäiv	N;NOM;SG
emähebo	emähebo	N;NOM;SG
maks	maks	N;NOM;SG
puarma	puarma	N;NOM;SG
uroz	uroz	N;ACC;SG
koskeda	kosken	V;IND;SG;1;POS;PRS
univermag	univermag	N;ACC;SG
lapsi	lapset	N;NOM;PL
kattada	katan	V;IND;SG;1;POS;PRS
rod	rod	N;NOM;SG
virg	virg	N;ACC;SG
side	side	N;ACC;SG
keroi	keroi	N;ACC;SG
muaemä	muaemä	N;NOM;SG
čuuru	čuuru	N;ACC;SG
apara	apara	N;ACC;SG
golub	golub	N;NOM;SG
sinä	sinä	PRO;ACC;SG
ogorod	ogorod	N;ACC;SG
piäskuohut	piäskuohut	N;ACC;SG
möükkü	möükkü	N;ACC;SG
pühkim	pühkim	N;ACC;SG
Syrde	Sürd’e	PROPN;NOM;SG
nämä	nämä	PRO;ACC;PL
rande	rande	N;NOM;SG
petl’	petl’	N;NOM;SG
piiri	piiri	N;NOM;SG
dialekt	dialekt	N;ACC;SG
sumba	sumba	ADJ;NOM;SG
rodidakse	rodiimos	V;IPFV;IND;SG;1;POS;PST;REFL
rüüstäžei	rüüstäžei	N;ACC;SG
olda	en ole	V;IND;SG;1;NEG;PRS
lämč	lämč	N;NOM;SG
ručke	ručke	N;NOM;SG
pogost	pogostal	N;AT+ESS;SG
püörie	püörie	ADJ;ACC;SG
kulde	kulde	N;ACC;SG
tahk	tahk	N;ACC;SG
vačča	vačča	N;ACC;SG
stantsii	stantsii	N;ACC;SG
artikkeli	artikkeli	N;ACC;SG
nižu	nižu	N;ACC;SG
birde	birde	N;NOM;SG
suovepuu	suovepuu	N;NOM;SG
luuda	luuda	N;NOM;SG
tyyryd	tyyryd	N;ACC;SG
vazaine	vazaine	N;ACC;SG
sumbe	sumbe	ADJ;ACC;SG
gorelke	gorelke	N;NOM;SG
vilkke	vilkke	N;NOM;SG
sanoda	sanotah	V;IND;PL;3;POS;PRS
pagana	pagana	ADJ;ACC;SG
udaluoi	udaluoi	ADJ;ACC;SG
televiizor	televiizor	N;ACC;SG
vacc	vacc	N;ACC;SG
kehnuoine	kehnuoine	ADJ;ACC;SG
päive	piän	N;FRML;SG
bošše	bošše	N;NOM;SG
niižpuu	niižpuu	N;NOM;SG
myödäi	myödäi	N;NOM;SG
tabakk	tabakk	N;ACC;SG
kažinpoige	kažinpoige	N;ACC;SG
tuom	tuom	N;NOM;SG
čaj	čaj	N;NOM;SG
žiivatta	žiivatta	N;NOM;SG
kringeli	kringeli	N;NOM;SG
kevaž	kevaž	N;NOM;SG
oja	oja	N;NOM;SG
laide	laide	N;ACC;SG
eraz	eraz	PRO;ACC;SG
tavara	tavara	N;ACC;SG
suomelaižet	suomelaižet	N;ACC;SG
ižännimi	ižännimi	N;ACC;SG
virolaine	virolaine	N;ACC;SG
silie	silie	ADJ;ACC;SG
zadače	zadače	N;NOM;SG
kijag	kijag	N;NOM;SG
vägövä	vägövä	ADJ;NOM;SG
valged	valged	ADJ;ACC;SG
tühje	tühje	ADJ;ACC;SG
kolmanpäiv	kolmanpäiv	N;ACC;SG
ruga	ruga	N;ACC;SG
konopattida	konopatin	V;IND;SG;1;POS;PRS
stali	stali	N;ACC;SG
südäinkerät	südäinkerät	N;NOM;SG
ribu	ribu	N;NOM;SG
barčoi	barčoi	N;NOM;SG
maijak	maijak	N;NOM;SG
nuodivo	nuodivo	N;NOM;SG
čondžuoi	čondžuoi	N;ACC;SG
diädö	diädöd	N;NOM;PL
nit’	nit’	N;ACC;SG
yliopišto	yliopišto	N;ACC;SG
lähimäine	lähimäine	ADJ;NOM;SG
ork	ork	N;NOM;SG
torba	torba	N;NOM;SG
astuda	astut	V;IND;SG;2;POS;PRS
kandapiä	kandapiä	N;NOM;SG
sana	sana	N;ACC;SG
mielöu	mielöu	ADJ;ACC;SG
suurin	suurin	N;ACC;SG
ruopas	ruopas	N;ACC;SG
ženih	ženih	N;ACC;SG
vunuk	vunukat	N;NOM;PL
püw	püw	N;ACC;SG
d’äkkeri	d’äkkeri	N;ACC;SG
abie	abie	N;ACC;SG
bohattir’	bohattir’	N;NOM;SG
kebd’	kebd’	ADJ;ACC;SG
penzii	penzijal	N;AT+ESS;SG
harv	harv	ADJ;ACC;SG
yö	yö	N;NOM;SG
šättä	šättä	N;NOM;SG
iškeda	išken	V;IND;SG;1;POS;PRS
luhte	luhte	N;ACC;SG
Nirkke	Nirkke	PROPN;NOM;SG
miäre	miäre	N;NOM;SG
lakke	lakke	N;NOM;SG
murčuk	murčuk	N;NOM;SG
kazinpoig	kazinpoig	N;NOM;SG
podval	podvaloispiäi	N;IN+ABL;PL
toukka	toukka	N;NOM;SG
päiväne	päiväne	N;ACC;SG
melida	melin	V;IND;SG;1;POS;PRS
röčče	röčče	N;ACC;SG
kanttez	kanttez	N;NOM;SG
muanhardii	muanhardii	N;NOM;SG
d’oukko	d’oukko	N;NOM;SG
Lahdenpohje	Lahdenpohje	PROPN;NOM;SG
pard	pard	N;ACC;SG
ruoda	ruoda	N;ACC;SG
paimuo	paimuo	N;ACC;SG
šota	šota	N;NOM;SG
skuuppa	skuuppa	ADJ;ACC;SG
tedri	tedri	N;ACC;SG
muiguoitus	muiguoitus	N;ACC;SG
uudim	uudim	N;ACC;SG
mozgut	mozgut	N;NOM;SG
tuulas	tuulas	N;ACC;SG
vard’oita	vard’oiččou	V;IND;SG;3;POS;PRS
huaža	huaža	N;NOM;SG
basketbol	basketbol	N;NOM;SG
vuapsahane	vuapsahane	N;ACC;SG
astuvoita	astuvoičen	V;IND;SG;1;POS;PRS
ščokad	ščokad	N;ACC;SG
talv	talv	N;ACC;SG
kumi	kumi	N;ACC;SG
meži	meži	N;ACC;SG
treske	treske	N;NOM;SG
maltada	maltoi	V;IPFV;IND;SG;3;POS;PST
kürze	kürze	N;NOM;SG
kuivakala	kuivakala	N;NOM;SG
šieglanpiälüzet	šieglanpiälüzet	N;ACC;SG
t’oska	t’oska	N;NOM;SG
sanoda	sanot	V;IND;SG;2;POS;PRS
grača	grača	N;ACC;SG
tal’v	tal’v	N;NOM;SG
taluoi	taluoi	N;ACC;SG
purnu	purnu	N;ACC;SG
kühläs	kühläs	N;NOM;SG
maske	maske	N;ACC;SG
kirjaopastu	kirjaopastu	N;NOM;SG
d’uoksu	d’uoksu	N;ACC;SG
pilla	pilla	N;ACC;SG
bl’uud’ečke	bl’uud’ečke	N;ACC;SG
kyl’bkost’um	kyl’bkost’um	N;ACC;SG
haugot	haugot	N;ACC;SG
härg	härg	N;NOM;SG
buab	buab	N;NOM;SG
adress	adress	N;ACC;SG
haumeh	haumeh	N;ACC;SG
loukko	loukko	N;ACC;SG
äjäpäiv	äjäpäiv	N;ACC;SG
uwtates	uwtates	N;ACC;SG
čiidal	čiidal	N;ACC;SG
Kard’al	Kard’al	PROPN;ACC;SG
tuisku	tuisku	N;ACC;SG
svetaane	svetaane	N;ACC;SG
huudeh	huudeh	N;ACC;SG
siled	siled	ADJ;ACC;SG
ozr	ozr	N;NOM;SG
rubi	rubi	N;NOM;SG
tihi	tihi	N;ACC;SG
paide	paide	N;NOM;SG
sappi	sappi	N;NOM;SG
oččetukad	oččetukad	N;NOM;SG
rajak	rajak	N;NOM;SG
kuvahaine	kuvahaine	N;NOM;SG
aparod	aparod	N;NOM;SG
razva	razva	N;NOM;SG
polos	polos	N;NOM;SG
helm	helm	N;NOM;SG
sina	sina	PRO;NOM;SG
harve	harve	ADJ;ACC;SG
lyydilaine	lyydilaine	N;ACC;SG
luodo	luodo	N;NOM;SG
hien	hien	ADJ;ACC;SG
kunnetahto	kunnetahto	PRO;ACC;SG
udostoverenii	udostoverenii	N;ACC;SG
doršš	doršš	N;NOM;SG
karv	karv	N;NOM;SG
lidn	lidn	N;NOM;SG
kapotta	kapotta	N;NOM;SG
nelläispäivä	nelläispäivä	N;NOM;SG
eht	eht	N;NOM;SG
poteh	poteh	N;NOM;SG
mečče	mečän	N;ACC;SG
roskaine	roskaine	N;NOM;SG
närittädä	näritän	V;IND;SG;1;POS;PRS
ratas	ratas	N;NOM;SG
säres	säres	N;NOM;SG
čihve	čihve	N;NOM;SG
takka	takka	N;NOM;SG
muile	muile	N;NOM;SG
täüzigäine	täüzigäine	ADJ;ACC;SG
fufaike	fufaike	N;ACC;SG
laukku	laukku	N;ACC;SG
d’uadre	d’uadre	N;ACC;SG
sirott	sirott	N;ACC;SG
šelgäluu	šelgäluu	N;NOM;SG
banke	banke	N;NOM;SG
oboda	oboda	N;NOM;SG
höihen	höihen	N;NOM;SG
kude	kude	N;NOM;SG
počč	počč	N;ACC;SG
kover	kover	ADJ;NOM;SG
kauzi	kauzi	N;ACC;SG
polovikke	polovikke	N;NOM;SG
hukk	hukk	N;NOM;SG
poklon	poklon	N;NOM;SG
ikr	ikr	N;NOM;SG
buola	buola	N;ACC;SG
pölü	pölü	N;NOM;SG
tačma	tačma	N;NOM;SG
plemännikke	plemännikke	N;NOM;SG
d’uosta	d’uoksen	V;IND;SG;1;POS;PRS
lötüöi	lötüöi	N;ACC;SG
katuz	katuz	N;ACC;SG
pakita	pakičen	V;IND;SG;1;POS;PRS
sukset	sukset	N;NOM;SG
ferezi	ferezi	N;ACC;SG
oruž	oruž	N;ACC;SG
šiär’	šiär’	N;NOM;SG
lappalažet	lappalažet	N;ACC;SG
tamma	tamma	N;NOM;SG
tiedomiez’	tiedomiez’	N;ACC;SG
kuoma	kuoma	N;ACC;SG
vel’l’	vel’l’	N;ACC;SG
materij	materij	N;NOM;SG
tuuče	tuuče	N;NOM;SG
varuu	varuu	N;NOM;SG
olda	olet	V;IND;SG;2;POS;PRS
piäskyöi	piäskyöi	N;ACC;SG
mujeh	mujeh	N;NOM;SG
astuda	astuiš	V;COND;SG;3;POS;PRS
muroitez	muroitez	N;ACC;SG
suobatt	suobatt	N;ACC;SG
toine	toižele	ADJ;AT+ALL;SG
počče	počče	N;ACC;SG
sluave	sluave	N;ACC;SG
pieluz	pieluz	N;ACC;SG
ägez	ägez	N;ACC;SG
d’älgatuoi	d’älgatuoi	ADJ;NOM;SG
kuiva	kuiva	ADJ;NOM;SG
kuif	kuif	ADJ;NOM;SG
pohd’a	pohd’a	N;ACC;SG
starikka	starikka	N;ACC;SG
kubo	kubo	N;ACC;SG
lapsed	lapsed	N;ACC;SG
suahari	suahari	N;ACC;SG
päre	päre	N;ACC;SG
vahn	vahn	ADJ;ACC;SG
kündüs	kündüs	N;ACC;SG
čepče	čepče	N;ACC;SG
koja	koja	N;NOM;SG
penzii	penzii	N;NOM;SG
dubin	dubin	N;NOM;SG
libed	libed	ADJ;NOM;SG
sina	sina	PRO;ACC;SG
pert’	pert’	N;ACC;SG
saraklinduine	saraklinduine	N;ACC;SG
upota	upponen	V;IND;SG;1;POS;PRS
nimidä	nimidä	PRO;ACC;SG
ondž	ondž	N;ACC;SG
blokke	blokke	N;NOM;SG
tihed	tihed	N;NOM;SG
hurstiine	hurstiine	N;NOM;SG
rajakko	rajakko	N;NOM;SG
avadim	avadim	N;NOM;SG
zatinke	zatinke	N;NOM;SG
lambas	lambas	N;ACC;SG
n’okke	n’okke	N;NOM;SG
toahitukku	toahitukku	N;ACC;SG
platform	platform	N;NOM;SG
aiga	aiga	N;NOM;SG
siera	siera	N;ACC;SG
salba	salba	N;NOM;SG
virzi	virzi	N;ACC;SG
sroičče	sroičče	N;ACC;SG
neveska	neveska	N;ACC;SG
uuži	uuži	ADJ;NOM;SG
Pyhärvi	Pyhärvespäi	PROPN;IN+ABL;SG
metle	metle	N;ACC;SG
harmag	harmag	ADJ;ACC;SG
ruškičče	ruškičče	N;NOM;SG
suvi	suvi	N;NOM;SG
niitti	niitti	N;NOM;SG
kang	kang	N;ACC;SG
pyörysport	pyörysport	N;NOM;SG
vill	vill	N;NOM;SG
astuda	älgäh astugah	V;IMP;PL;3;NEG
suug	suug	N;ACC;SG
küpsi	küpsi	ADJ;ACC;SG
čikko	čikko	N;NOM;SG
maha	maha	N;NOM;SG
Nirkke	Nirkke	PROPN;ACC;SG
aige	aige	N;ACC;SG
raukke	raukke	N;NOM;SG
rikki	rikki	N;NOM;SG
piiva	piiva	N;NOM;SG
potok	potok	N;NOM;SG
luistilii	luistilii	N;ACC;SG
taivahankarvaane	taivahankarvaane	ADJ;NOM;SG
puaksud	puaksud	ADJ;NOM;SG
syvä	syvä	ADJ;ACC;SG
rega	rega	N;ACC;SG
šülü	šülü	N;ACC;SG
kost’urke	kost’urke	N;ACC;SG
loittone	loittone	ADJ;NOM;SG
harakteri	harakteri	N;NOM;SG
riäpyöi	riäpyöi	N;NOM;SG
ristikanza	ristikanza	N;NOM;SG
oma	oma	ADJ;ACC;SG
kaski	kaski	N;ACC;SG
loppu	loppu	N;ACC;SG
ketut	ketut	N;NOM;SG
küngä	küngä	N;ACC;SG
pašport	pašport	N;NOM;SG
huab	huab	N;ACC;SG
kerätä	kerädan	V;IND;SG;1;POS;PRS
heimokunda	heimokunda	N;ACC;SG
ruogačču	ruogačču	N;ACC;SG
palau	palau	ADJ;NOM;SG
idu	idu	N;ACC;SG
siib	siib	N;ACC;SG
tulukset	tulukset	N;ACC;SG
puali	puali	N;ACC;SG
igävä	igävä	N;NOM;SG
gurb	gurb	N;NOM;SG
kulakko	kulakko	N;ACC;SG
suml’uita	suml’uičen	V;IND;SG;1;POS;PRS
kivi	kived	N;NOM;PL
d’augumiäčč	d’augumiäčč	N;ACC;SG
ilm	ilm	N;ACC;SG
puatoke	puatoke	N;NOM;SG
muuras	muuras	N;NOM;SG
vahne	vahne	ADJ;NOM;SG
liede	liede	N;NOM;SG
kouk	kouk	N;NOM;SG
sorza	sorza	N;NOM;SG
külgi	külgi	N;NOM;SG
tatoi	tatoi	N;NOM;SG
murčukka	murčukka	N;ACC;SG
pakottada	pakotetah	V;IND;PL;3;POS;PRS
čakkavo	čakkavo	N;ACC;SG
künzi	künzi	N;ACC;SG
mändä	mäni	V;IPFV;IND;SG;3;POS;PST
suičet	suičet	N;ACC;SG
šofer	šofer	N;NOM;SG
loimi	loimi	N;ACC;SG
aspirant	aspirant	N;ACC;SG
pajo	pajo	N;NOM;SG
raud	raud	N;NOM;SG
okšeta	okšendan	V;IND;SG;1;POS;PRS
ram	ram	ADJ;ACC;SG
pila	pila	N;ACC;SG
poštukartočk	poštukartočk	N;ACC;SG
eräs	eräs	PRO;NOM;SG
tämä	tämän	PRO;ACC;SG
kelloine	kelloine	N;NOM;SG
starik	starik	N;NOM;SG
kudamida	kudamida	PRO;ACC;SG
karvahaine	karvahaine	ADJ;ACC;SG
libei	libei	ADJ;ACC;SG
vuož	vuož	N;ACC;SG
kapputt	kapputt	N;ACC;SG
nel’lanpäiv	nel’lanpäiv	N;NOM;SG
haju	haju	N;ACC;SG
mečče	mečässuai	N;TERM;SG
ödönöi	ödönöi	N;NOM;SG
lapsestuz	lapsestuz	N;NOM;SG
lumi	lumi	N;ACC;SG
muju	muju	N;ACC;SG
kiel’	kiel’	N;ACC;SG
tie	tie	N;ACC;SG
minut	minut	N;NOM;SG
nasmorke	nasmorke	N;NOM;SG
šaglad	šaglad	N;NOM;SG
airo	airo	N;ACC;SG
eländtaba	eländtaba	N;NOM;SG
podval	podvalas	N;IN+ESS;SG
siäriluu	siäriluu	N;ACC;SG
händikäs	händikäs	N;NOM;SG
bratan	bratan	N;NOM;SG
rihm	rihm	N;NOM;SG
vašk	vašk	N;NOM;SG
üölie	üölie	N;ACC;SG
bruus	bruus	N;NOM;SG
suo	suo	N;NOM;SG
korzi	korzi	N;NOM;SG
šiim	šiim	N;NOM;SG
pereh	perehes	N;IN+ESS;SG
elgeta	elgendäy	V;IND;SG;3;POS;PRS
brujad	brujad	N;ACC;SG
suarna	suarna	N;NOM;SG
paikk	paikk	N;NOM;SG
kyndys	kyndys	N;NOM;SG
vieras	vieras	N;NOM;SG
kieli	kieli	N;ACC;SG
maidot	maidot	N;ACC;SG
šaikke	šaikke	N;ACC;SG
m’amlida	m’amlin	V;IND;SG;1;POS;PRS
astuda	astuimme	V;IPFV;IND;PL;1;POS;PST
huahl	huahl	N;NOM;SG
kiirehtidä	kiirehtin	V;IND;SG;1;POS;PRS
mečče	mecata	N;PRIV;SG
viehkuri	viehkuri	N;NOM;SG
salmi	salmi	N;ACC;SG
laštvod	laštvod	N;ACC;SG
tazaine	tazaine	ADJ;ACC;SG
rukki	rukki	N;ACC;SG
rahkiš	rahkiš	N;NOM;SG
doroga	doroga	N;NOM;SG
laukka	laukka	N;NOM;SG
bies	bies	N;NOM;SG
küuk	küuk	N;NOM;SG
gorničče	gorničče	N;NOM;SG
n’umal	n’umalad	N;NOM;PL
lämm	lämm	ADJ;ACC;SG
sormi	sormi	N;NOM;SG
čihl	čihl	N;ACC;SG
mecc	mecc	N;ACC;SG
pagana	pagana	ADJ;NOM;SG
nuotte	nuotte	N;ACC;SG
sundug	sundug	N;ACC;SG
strelke	strelke	N;ACC;SG
raide	raide	N;NOM;SG
zontikke	zontikke	N;NOM;SG
čirgat	čirgat	N;NOM;SG
taibal	taibal	N;NOM;SG
biibalo	biibalo	N;NOM;SG
vihm	vihm	N;NOM;SG
mečče	mečispiäi	N;IN+ABL;PL
näppi	näppi	N;NOM;SG
t’orke	t’orke	N;NOM;SG
ardeh	ardeh	N;NOM;SG
sustav	sustav	N;NOM;SG
pill	pill	N;NOM;SG
moni	moni	PRO;NOM;SG
sinä	sinä	PRO;NOM;SG
viha	viha	ADJ;ACC;SG
hiilau	hiilau	ADJ;ACC;SG
rände	rände	N;NOM;SG
norka	norka	N;NOM;SG
halgo	halgod	N;NOM;PL
vagavaane	vagavaane	ADJ;ACC;SG
bazar	bazar	N;NOM;SG
šokke	šokke	N;NOM;SG
ristimä	ristimä	N;NOM;SG
vahahine	vahahine	N;ACC;SG
soraheine	soraheine	N;NOM;SG
štuke	štuke	N;NOM;SG
vill’a	vill’a	N;NOM;SG
kauniš	kauniš	ADJ;NOM;SG
sumu	sumu	N;NOM;SG
lidna	lidna	N;ACC;SG
kello	kello	N;ACC;SG
huahmuo	huahmuo	N;ACC;SG
vilkke	vilkke	N;ACC;SG
kaži	kažil	N;AT+ESS;SG
vihuri	vihuri	N;ACC;SG
siga	siga	N;NOM;SG
raudtieazem	raudtieazem	N;ACC;SG
tütär	tütär	N;ACC;SG
sroičanpäiv	sroičanpäiv	N;ACC;SG
veičči	veičči	N;NOM;SG
kobre	kobre	N;NOM;SG
ristintytär	ristintytär	N;NOM;SG
piirua	piirua	N;ACC;SG
obšivke	obšivke	N;NOM;SG
huuhkaja	huuhkaja	N;NOM;SG
Norja	Norja	PROPN;ACC;SG
poige	poige	N;NOM;SG
mečče	mecasssuai	N;TERM;SG
küpse	küpse	ADJ;NOM;SG
sagarvo	sagarvo	N;ACC;SG
näivištynny	näivištynny	ADJ;NOM;SG
vuottiet	vuottiet	N;NOM;SG
syömiine	syömiine	N;NOM;SG
abu	abul	N;AT+ESS;SG
pakaažkuu	pakaažkuu	N;ACC;SG
aida	aida	N;ACC;SG
kebd’	kebd’	ADJ;NOM;SG
keriččimet	keriččimet	N;NOM;SG
rygimiine	rygimiine	N;NOM;SG
nähtavyys	nähtavyysed	N;NOM;PL
pahne	pahne	N;NOM;SG
lendoazem	lendoazem	N;NOM;SG
kofeinikke	kofeinikke	N;NOM;SG
püörde	püörde	N;NOM;SG
vard’oita	vard’oiččis	V;COND;SG;3;POS;PRS
imeli	imeli	N;NOM;SG
ruadai	ruadajat	N;NOM;PL
ribu	ribu	N;ACC;SG
maijak	maijak	N;ACC;SG
nuodivo	nuodivo	N;ACC;SG
südäinkerät	südäinkerät	N;ACC;SG
barčoi	barčoi	N;ACC;SG
zadače	zadače	N;ACC;SG
liha	liha	N;NOM;SG
sarahpana	sarahpana	N;ACC;SG
šukka	šukka	N;ACC;SG
regä	regä	N;ACC;SG
homm	homm	N;ACC;SG
suol	suol	N;ACC;SG
giir’e	giir’e	N;NOM;SG
čakata	čakkadan	V;IND;SG;1;POS;PRS
grafin	grafin	N;NOM;SG
rahat	rahat	N;ACC;SG
pidädä	pidi	V;IPFV;IND;SG;3;POS;PST
kodi	kodis	N;IN+ESS;SG
bruusoi	bruusoi	N;ACC;SG
poigindam	poigindam	N;ACC;SG
tütar	tütar	N;ACC;SG
sarge	sarge	N;NOM;SG
d’algačim	d’algačim	N;NOM;SG
palaine	palaine	N;NOM;SG
bohattir’	bohattir’	N;ACC;SG
igen	igen	N;ACC;SG
mikš	mikš	PRO;NOM;SG
kalina	kalina	N;NOM;SG
kindas	kindahad	N;NOM;PL
orbo	orbo	N;NOM;SG
verkkomiäččykižai	verkkomiäččykižai	N;ACC;SG
bokki	bokki	N;ACC;SG
karžut	karžut	N;NOM;SG
piä	piä	N;NOM;SG
seižoda	seižon	V;IND;SG;1;POS;PRS
modnuoi	modnuoi	ADJ;ACC;SG
šündünmua	šündünmua	N;NOM;SG
brosse	brosse	N;ACC;SG
pinde	pinde	N;ACC;SG
habu	habu	N;NOM;SG
reng	reng	N;ACC;SG
kilometr	kilometr	N;ACC;SG
gruuzuoi	gruuzuoi	N;ACC;SG
kuolend	kuolend	N;ACC;SG
omad	omah	N;IN+ALL;SG
pohde	pohde	N;ACC;SG
pimie	pimie	ADJ;ACC;SG
bohat	bohat	ADJ;ACC;SG
pesku	pesku	N;NOM;SG
raha	raha	N;NOM;SG
kord’a	kord’a	N;NOM;SG
maksande	maksande	N;ACC;SG
kedo	kedo	N;ACC;SG
tulovišč	tulovišč	N;NOM;SG
nuotta	nuotta	N;NOM;SG
astuda	emme ole astunu	V;PRF;IND;PL;1;NEG;PST
bumaga	bumaga	N;NOM;SG
svorčč	svorčč	N;NOM;SG
kuokk	kuokk	N;NOM;SG
žerebei	žerebei	N;NOM;SG
päivänlasku	päivänlasku	N;NOM;SG
puarus’s’a	puarus’s’a	N;NOM;SG
peldovaruoi	peldovaruoi	N;NOM;SG
d’älgatuoi	d’älgatuoi	ADJ;ACC;SG
kuif	kuif	ADJ;ACC;SG
aspirant	aspirantuun	N;GEN;PL
murgina	murgina	N;ACC;SG
giire	giire	N;ACC;SG
virui	virui	ADJ;NOM;SG
häkki	häkki	N;ACC;SG
keppi	keppi	N;ACC;SG
kindas	kindas	N;NOM;SG
roude	roude	N;ACC;SG
arge	arge	ADJ;ACC;SG
igen’	igenet	N;NOM;PL
päččilaude	päččilaude	N;ACC;SG
glavnuoi	glavnuoi	ADJ;NOM;SG
mägi	mäged	N;NOM;PL
buab	buab	N;ACC;SG
kauh	kauh	N;NOM;SG
paglad	paglad	N;ACC;SG
käpče	käpče	N;NOM;SG
hajukas	hajukas	ADJ;NOM;SG
kylmkuu	kylmkuu	N;NOM;SG
minä	minä	PRO;NOM;SG
muda	muda	N;ACC;SG
tahkadai	tahkadai	N;ACC;SG
fabrikke	fabrikke	N;ACC;SG
šivut	šivut	N;ACC;SG
süvä	süvä	ADJ;NOM;SG
kard’alažet	kard’alažet	N;ACC;SG
hüubüö	hüubüö	N;ACC;SG
köühä	köühä	ADJ;NOM;SG
helm	helm	N;ACC;SG
voida	emme voi	V;IND;PL;1;NEG;PRS
sobad	sobad	N;NOM;SG
tytär	tytär	N;NOM;SG
lange	lange	N;NOM;SG
virkkada	virkan	V;IND;SG;1;POS;PRS
valged	Valgedas	ADJ;IN+ESS;SG
nelläšpäivä	nelläšpäivä	N;NOM;SG
vaiget	vaiget	ADJ;NOM;SG
petl’a	petl’a	N;NOM;SG
drobe	drobe	N;NOM;SG
heimo	heimo	N;ACC;SG
samovar	samovar	N;ACC;SG
kadai	kadai	N;ACC;SG
tošargi	tošargi	N;ACC;SG
urakka	urakka	N;NOM;SG
eläi	eläi	N;NOM;SG
sulge	sulge	N;NOM;SG
pučči	pučči	N;NOM;SG
nukkuda	nukun	V;IND;SG;1;POS;PRS
kodi	kodi	N;ACC;SG
pihke	pihke	N;ACC;SG
hattu	hattu	N;NOM;SG
ong	ong	N;NOM;SG
kon’ak	kon’ak	ADJ;NOM;SG
čisle	čisle	N;NOM;SG
loituoine	loituoine	ADJ;ACC;SG
käzipaik	käzipaik	N;NOM;SG
höihen	höihen	N;ACC;SG
kude	kude	N;ACC;SG
strela	strela	N;NOM;SG
syli	syli	N;NOM;SG
lugii	lugii	N;NOM;SG
niegla	niegla	N;ACC;SG
čiirgat	čiirgat	N;ACC;SG
pyhärvelaine	pyhärvelaine	N;NOM;SG
saum	saum	N;NOM;SG
puik	puik	N;NOM;SG
kägüöi	kägüöi	N;NOM;SG
biliette	biliette	N;NOM;SG
kuldoi	kuldoi	N;ACC;SG
tuske	tuske	N;NOM;SG
ruoppaz	ruoppaz	N;NOM;SG
orava	orava	N;NOM;SG
šitt	šitt	N;ACC;SG
grozida	grozin	V;IND;SG;1;POS;PRS
kuivata	kuivadan	V;IND;SG;1;POS;PRS
hoppu	hoppu	N;NOM;SG
päčči	päčči	N;NOM;SG
sukset	sukset	N;ACC;SG
köyhe	köyhe	ADJ;ACC;SG
počči	počči	N;ACC;SG
kirzi	kirzi	N;NOM;SG
hüübie	hüübie	N;NOM;SG
kaima	kaima	N;NOM;SG
ram	ram	ADJ;NOM;SG
mečče	mecoiden	N;GEN;PL
armahaine	armahaine	ADJ;ACC;SG
ahtas	ahtas	ADJ;ACC;SG
loitombi	loitombi	ADJ;NOM;SG
minä	Minul	PRO;AT+ESS;SG
häi	häi	PRO;ACC;SG
pendu	pendu	N;NOM;SG
sume	sume	N;ACC;SG
praude	praude	N;ACC;SG
voigriba	voigriba	N;ACC;SG
pošt	pošt	N;ACC;SG
tyl’če	tyl’če	ADJ;ACC;SG
niižu	niižu	N;NOM;SG
bašlikke	bašlikke	N;NOM;SG
sudne	sudne	N;ACC;SG
mal’l’a	mal’l’a	N;ACC;SG
matke	matke	N;ACC;SG
pert’t’i	pert’t’i	N;NOM;SG
nedäli	nedäli	N;ACC;SG
höyhen	höyhen	N;NOM;SG
tahne	tahne	N;NOM;SG
d’ablokke	d’ablokke	N;ACC;SG
sallo	sallo	N;ACC;SG
koppal	koppal	N;ACC;SG
kouhkot	kouhkot	N;NOM;SG
niemi	niemi	N;ACC;SG
vadnas	vadnas	N;ACC;SG
pölkkü	pölkkü	N;NOM;SG
orane	orane	N;NOM;SG
laut	laut	N;NOM;SG
pärpäččü	pärpäččü	N;NOM;SG
avaiduda	avaiduttih	V;IPFV;IND;PL;3;POS;PST;REFL
astuda	astugah	V;IMP;SG;3;POS
loittone	loittone	ADJ;ACC;SG
tačm	tačm	N;NOM;SG
pordhat	pordhat	N;NOM;SG
Brus’a	Brus’ad	PROPN;PRT;SG
taivahankarvaane	taivahankarvaane	ADJ;ACC;SG
avadim	avadim	N;ACC;SG
hallot	hallot	N;ACC;SG
arvoitus	arvoitus	N;ACC;SG
haugi	haugi	N;ACC;SG
agd’	agd’	N;ACC;SG
nodrei	nodrei	ADJ;ACC;SG
pirgaažed	pirgaažed	N;NOM;SG
kukuo	kukuo	N;ACC;SG
kohta	kohta	N;ACC;SG
rujod	rujod	N;NOM;SG
kurki	kurki	N;NOM;SG
detsad	detsaduz	N;IN+ESS;SG
hän	hän	PRO;NOM;SG
VepKar	VepKar	PROPN;NOM;SG
meččuo	meččuo	N;ACC;SG
kukko	kukko	N;ACC;SG
huohehembi	huohehembi	ADJ;NOM;SG
hägärä	hägärä	N;ACC;SG
luzik	luzik	N;ACC;SG
pagišta	pagižimme	V;IPFV;IND;PL;1;POS;PST
äi	äi	ADJ;NOM;SG
nuoli	nuoli	N;NOM;SG
kolmašpäivä	kolmašpäivä	N;ACC;SG
trupka	trupka	N;NOM;SG
zabiakke	zabiakke	N;NOM;SG
aiže	aiže	N;NOM;SG
sormus	sormus	N;NOM;SG
ruoččilaine	ruoččilaine	N;ACC;SG
šiliä	šiliä	ADJ;NOM;SG
höstö	höstö	N;ACC;SG
lainata	lainadan	V;IND;SG;1;POS;PRS
ristiža	ristiža	N;NOM;SG
kasse	kasse	N;NOM;SG
kagr	kagr	N;ACC;SG
velge	velge	N;ACC;SG
külgi	külgi	N;ACC;SG
šIne	šIne	N;NOM;SG
pöürü	pöürü	N;NOM;SG
pitke	pitke	ADJ;ACC;SG
notkie	notkie	ADJ;ACC;SG
mužikka	mužikka	N;ACC;SG
liede	liede	N;ACC;SG
kouk	kouk	N;ACC;SG
sorza	sorza	N;ACC;SG
nellänpäive	nellänpäive	N;NOM;SG
rukke	rukke	N;ACC;SG
šilda	šilda	N;ACC;SG
viilehüš	viilehüš	N;NOM;SG
dyrk	dyrk	ADJ;NOM;SG
laho	laho	ADJ;ACC;SG
orl	orl	N;ACC;SG
tobd’	tobd’at	ADJ;NOM;PL
haikostada	haikostan	V;IND;SG;1;POS;PRS
pöly	pöly	N;ACC;SG
lükkü	lükkü	N;ACC;SG
sebä	sebä	N;NOM;SG
tulda	tulou	V;IND;SG;3;POS;PRS
razavhine	razavhine	ADJ;ACC;SG
salgamo	salgamo	N;ACC;SG
puoli	puoli	N;ACC;SG
kyben	kyben	N;ACC;SG
merk	merk	N;NOM;SG
kyrze	kyrze	N;NOM;SG
emändä	emändä	N;NOM;SG
olgi	olgi	N;NOM;SG
nerve	nerve	N;NOM;SG
harav	harav	N;ACC;SG
poštud’aššik	poštud’aššik	N;ACC;SG
vuozi	vuozi	N;ACC;SG
kurg	kurg	N;NOM;SG
Venä	Venä	PROPN;NOM;SG
keskškola	keskškola	N;NOM;SG
oraine	oraine	N;ACC;SG
täin	täin	N;ACC;SG
keričii	keričii	N;ACC;SG
rihm	rihm	N;ACC;SG
časouna	časouna	N;NOM;SG
vikkatteh	vikkatteh	N;NOM;SG
oružd’	oružd’	N;ACC;SG
tora	tora	N;NOM;SG
tuučče	tuučče	N;NOM;SG
luht	luht	N;ACC;SG
pesk	pesk	N;ACC;SG
halgod	halgod	N;ACC;SG
zirkalo	zirkalo	N;ACC;SG
muil	muil	N;ACC;SG
šahlut	šahlut	N;ACC;SG
šelgüs	šelgüs	N;NOM;SG
verk	verk	N;NOM;SG
nordie	nordie	ADJ;ACC;SG
gniede	gniede	ADJ;ACC;SG
šeba	šeba	N;NOM;SG
ratas	ratas	N;ACC;SG
zaftrokk	zaftrokk	N;ACC;SG
dorog	dorogad	N;PRT;SG
agd’e	agd’e	N;NOM;SG
mučukke	mučukke	N;NOM;SG
päi	päi	N;NOM;SG
šuapug	šuapug	N;NOM;SG
arššina	arššina	N;ACC;SG
dälgi	dälgi	N;ACC;SG
riäpöi	riäpöi	N;ACC;SG
internuot	internuot	N;NOM;SG
bahalauk	bahalauk	N;NOM;SG
knige	knige	N;NOM;SG
šuapke	šuapke	N;NOM;SG
molodče	molodče	N;NOM;SG
leva	leva	N;NOM;SG
hiilau	hiilau	ADJ;NOM;SG
nagle	nagle	N;ACC;SG
sügüz’	sügüz’	N;ACC;SG
kagre	kagre	N;ACC;SG
külä	küläs	N;IN+ESS;SG
kande	kande	N;NOM;SG
mečkana	mečkana	N;NOM;SG
rahtvezi	rahtvezi	N;NOM;SG
ruadai	ruadai	N;NOM;SG
arbadus	arbadus	N;ACC;SG
hobie	hobie	N;ACC;SG
perednikke	perednikke	N;ACC;SG
tori	tori	N;NOM;SG
tik	tik	N;NOM;SG
lapsiinpert’	lapsiinpert’	N;ACC;SG
parz’	parz’	N;NOM;SG
kerag	kerag	N;NOM;SG
vederista	vederista	N;NOM;SG
nenätyöi	nenätyöi	ADJ;NOM;SG
tomu	tomu	N;ACC;SG
pill	pill	N;ACC;SG
t’orke	t’orke	N;ACC;SG
vagava	vagava	ADJ;ACC;SG
kird’a	kird’a	N;NOM;SG
päive	päivän	N;FRML;SG
maakondijane	maakondijane	N;ACC;SG
kaži	kaži	N;ACC;SG
bazar	bazar	N;ACC;SG
mikse	mikse	PRO;ACC;SG
varaita	varaiži	V;IPFV;IND;SG;3;POS;PST
pacas	pacas	N;NOM;SG
starikke	starikke	N;NOM;SG
surjak	surjak	N;NOM;SG
štuke	štuke	N;ACC;SG
čort	čort	N;ACC;SG
veziriste	veziriste	N;ACC;SG
Pyhärvi	Pyhärvespiäi	PROPN;IN+ABL;SG
korvo	korvo	N;NOM;SG
lastu	lastu	N;NOM;SG
norka	norka	N;ACC;SG
torgu	torgu	N;NOM;SG
käzirüüstä	käzirüüstä	N;NOM;SG
kauniž	kauniž	ADJ;ACC;SG
lehme	lehmidneh	N;COM;PL
eivoinaine	eivoinaine	ADJ;NOM;SG
kotkuo	kotkuo	N;NOM;SG
piha	piha	N;ACC;SG
märgä	märgä	N;ACC;SG
raudad	raudad	N;NOM;SG
emag	emag	N;NOM;SG
mollembad	mollembad	PRO;NOM;SG
žoltuhe	žoltuhe	N;NOM;SG
abei	abei	N;NOM;SG
kargie	kargie	ADJ;ACC;SG
hiema	hiema	N;NOM;SG
arbe	arbe	N;NOM;SG
ehtä	ehtä	N;NOM;SG
bobra	bobra	N;NOM;SG
čuassu	čuassu	N;ACC;SG
alastuoi	alastuoi	ADJ;ACC;SG
tr’aske	tr’aske	N;NOM;SG
kuudain	kuudain	N;NOM;SG
baraban	baraban	N;NOM;SG
uuhuine	uuhuine	N;NOM;SG
harakanhein	harakanhein	N;NOM;SG
oboz	oboz	N;NOM;SG
mitüs	mitüs	PRO;ACC;SG
laukk	laukk	N;ACC;SG
mus’tuoi	mus’tuoi	N;ACC;SG
mielehine	mielehine	ADJ;NOM;SG
uneksida	uneksin	V;IND;SG;1;POS;PRS
piipp	piipp	N;NOM;SG
kabu	kabu	N;NOM;SG
paik	paik	N;NOM;SG
pedai	pedai	N;ACC;SG
zalošk	zalošk	N;NOM;SG
märgä	märgä	ADJ;ACC;SG
kibuhiine	kibuhiine	ADJ;ACC;SG
vagarm	vagarm	N;NOM;SG
lendoazem	lendoazem	N;ACC;SG
püörde	püörde	N;ACC;SG
pahne	pahne	N;ACC;SG
sveta	sveta	N;ACC;SG
liha	liha	N;ACC;SG
ližut	ližut	N;NOM;SG
vigli	vigli	N;NOM;SG
reiži	reiži	N;ACC;SG
pohd’	pohd’	N;ACC;SG
kier	kier	N;ACC;SG
siig	siig	N;ACC;SG
uuš	uuš	ADJ;NOM;SG
mugoine	mugoine	ADJ;NOM;SG
tadeh	tadeh	N;NOM;SG
časoune	časoune	N;NOM;SG
bohat	bohat	ADJ;NOM;SG
šur’d’akke	šur’d’akke	N;NOM;SG
sestri	sestri	N;NOM;SG
härge	härge	N;NOM;SG
zvonke	zvonke	N;NOM;SG
griäh	griäh	N;ACC;SG
üölevuoi	üölevuoi	N;ACC;SG
häkk	häkk	N;NOM;SG
hamaro	hamaro	N;ACC;SG
mužikke	mužikke	N;NOM;SG
püörd	püörd	N;ACC;SG
kaste	kaste	N;ACC;SG
lukk	lukk	N;ACC;SG
šuolet	šuolet	N;ACC;SG
stroičč	stroičč	N;ACC;SG
reppu	reppu	N;ACC;SG
kuurič	kuurič	N;NOM;SG
grammatik	grammatik	N;NOM;SG
ukazke	ukazke	N;NOM;SG
opastui	opastujad	N;NOM;PL
kerä	kerä	N;ACC;SG
dyged	dyged	ADJ;NOM;SG
kuive	kuive	ADJ;ACC;SG
lahn	lahn	N;ACC;SG
sarafan	sarafan	N;NOM;SG
zaloške	zaloške	N;NOM;SG
pala	pala	N;NOM;SG
zapas	zapas	N;NOM;SG
minä	minut	PRO;NOM;PL
derein’	derein’	N;NOM;SG
paha	paha	ADJ;NOM;SG
elädä	eli	V;IPFV;IND;SG;3;POS;PST
piäčöi	piäčöi	N;ACC;SG
kolmašpäi	kolmašpäi	N;ACC;SG
šofer	šofer	N;ACC;SG
kettu	kettu	N;NOM;SG
pajo	pajo	N;ACC;SG
avando	avando	N;ACC;SG
telaga	telaga	N;ACC;SG
taibaleh	taibaleh	N;ACC;SG
tatoi	tatoi	N;ACC;SG
pehu	pehu	N;NOM;SG
soime	soime	N;ACC;SG
voimatuoine	voimatuoine	ADJ;ACC;SG
süvä	süvä	ADJ;ACC;SG
pidädä	pidäy	V;IND;SG;3;POS;PRS
kainalo	kainalo	N;ACC;SG
haldivomiez’	haldivomiez’	N;ACC;SG
nuotta	nuotta	N;ACC;SG
jad	jad	N;NOM;SG
küdü	küdü	N;NOM;SG
mähände	mähände	N;NOM;SG
pordahat	pordahat	N;NOM;SG
br’ukve	br’ukve	N;NOM;SG
kärz	kärz	N;NOM;SG
kämmen	kämmen	N;NOM;SG
riäde	riäde	N;NOM;SG
oma	oma	ADJ;NOM;SG
hebommuard	hebommuard	N;NOM;SG
ruiž	ruiž	N;NOM;SG
vessel	vessel	N;ACC;SG
pilkeh	pilkeh	N;ACC;SG
kannates	kannates	N;ACC;SG
mečče	mecan	N;BYWAY;SG
sablahat	sablahat	N;NOM;SG
muilu	muilu	N;NOM;SG
mie	mie	PRO;ACC;SG
pora	pora	N;ACC;SG
vedo	vedo	N;ACC;SG
prikaz	prikaz	N;NOM;SG
kubišta	kubižen	V;IND;SG;1;POS;PRS
tahnuo	tahnuo	N;NOM;SG
poimites	poimites	N;ACC;SG
riido	riido	N;NOM;SG
kaftana	kaftana	N;ACC;SG
astuda	oližitte astunu	V;PRF;COND;PL;2;POS;PRS
tal’vkuu	tal’vkuu	N;NOM;SG
olda	ette olnuiš	V;IPFV;COND;PL;2;NEG;PST
kera	kera	N;ACC;SG
kongress	kongress	N;ACC;SG
kuldaine	kuldaine	ADJ;ACC;SG
vihanda	vihanda	ADJ;NOM;SG
dälgmääne	dälgmääne	ADJ;NOM;SG
kündüz	kündüz	N;NOM;SG
kier	kieral	N;AT+ESS;SG
iäni	iäni	N;ACC;SG
rikaš	rikaš	ADJ;NOM;SG
kiškoi	kiškoi	N;NOM;SG
snuap	snuap	N;ACC;SG
mamoi	mamoi	N;ACC;SG
mozgu	mozgu	N;ACC;SG
katto	katto	N;ACC;SG
nuokke	nuokke	N;ACC;SG
suarna	suarna	N;ACC;SG
šittaböröi	šittaböröi	N;NOM;SG
huahl	huahl	N;ACC;SG
hyvä	hyvä	ADJ;ACC;SG
lülü	lülü	N;ACC;SG
kajag	kajag	N;ACC;SG
vihel’tä	viheldan	V;IND;SG;1;POS;PRS
muččo	muččo	N;ACC;SG
ogala	ogala	N;NOM;SG
suabranpuu	suabranpuu	N;NOM;SG
kiäge	kiäge	N;NOM;SG
tähk	tähk	N;ACC;SG
d’umal	d’umal	N;NOM;SG
veneh	veneh	N;NOM;SG
ukš	ukš	N;NOM;SG
rauha	rauha	N;NOM;SG
sukkul	sukkul	N;NOM;SG
čiihuoi	čiihuoi	N;NOM;SG
kägintiäi	kägintiäi	N;NOM;SG
kero	kero	N;ACC;SG
kezä	kezä	N;ACC;SG
neičukke	neičukke	N;ACC;SG
ostada	ostetah	V;IND;PL;3;POS;PRS
pohje	pohje	N;ACC;SG
magadussija	magadussija	N;NOM;SG
akke	akke	N;ACC;SG
zvieri	zvieri	N;NOM;SG
d’umala	d’umala	N;ACC;SG
nedal’	nedal’	N;ACC;SG
herneg	herneg	N;ACC;SG
emände	emände	N;ACC;SG
voimatoine	voimatoine	N;NOM;SG
plotnikke	plotnikke	N;NOM;SG
šäigü	šäigü	N;NOM;SG
mečče	mecinnu	N;TERM;PL
čakk	čakk	N;ACC;SG
kauvas	kauvas	N;ACC;SG
vihme	vihme	N;NOM;SG
notket	notket	ADJ;ACC;SG
uuzi	uuden	ADJ;ACC;SG
paimen	paimen	N;NOM;SG
hyppidä	hypin	V;IND;SG;1;POS;PRS
šalg	šalg	N;NOM;SG
hebo	hebol	N;AT+ESS;SG
nit’t’	nit’t’	N;ACC;SG
vilu	vilu	ADJ;NOM;SG
piiri	piiris	N;IN+ESS;SG
mereži	mereži	N;ACC;SG
ikränk	ikränk	N;ACC;SG
pahk	pahk	N;ACC;SG
kluadi	kluadi	N;ACC;SG
kaima	kaima	N;ACC;SG
gos’t’	gos’t’	N;ACC;SG
hände	hände	N;ACC;SG
mökki	mökki	N;ACC;SG
smieluoi	smieluoi	ADJ;NOM;SG
telegä	telegä	N;NOM;SG
pordimuo	pordimuo	N;NOM;SG
pille	pille	N;ACC;SG
škilietta	škilietta	N;ACC;SG
hurštiene	hurštiene	N;ACC;SG
pehozet	pehozet	N;ACC;SG
leski	leski	N;NOM;SG
maiduine	maiduine	N;NOM;SG
jämei	jämei	ADJ;NOM;SG
savi	savi	N;NOM;SG
uuzi	uuzi	ADJ;ACC;SG
verai	verai	N;ACC;SG
tiähti	tiähti	N;ACC;SG
marankera	marankera	ADJ;NOM;SG
südämkeräižet	südämkeräižet	N;NOM;SG
biznesmiez’	biznesmiez’	N;NOM;SG
hüppijääne	hüppijääne	N;NOM;SG
kehnone	kehnone	ADJ;NOM;SG
ombelija	ombelija	N;ACC;SG
kaludin	kaludin	N;ACC;SG
last	last	N;ACC;SG
skluad	skluad	N;ACC;SG
laineh	laineh	N;ACC;SG
muli	muli	ADJ;NOM;SG
mečče	mečidksi	N;TRANS;PL
rodit’al’ad	rodit’al’ad	N;ACC;SG
gimnast	gimnast	N;ACC;SG
ruočid	ruočid	N;ACC;SG
arba	arba	N;ACC;SG
paikka	paikka	N;NOM;SG
kiändai	kiändai	N;NOM;SG
uhkuine	uhkuine	N;NOM;SG
kogo	kogo	N;NOM;SG
buaba	buaba	N;NOM;SG
orane	orane	N;ACC;SG
pölkkü	pölkkü	N;ACC;SG
kieža	kieža	N;NOM;SG
stuule	stuule	N;NOM;SG
huigie	huigie	N;NOM;SG
pajattada	pajatan	V;IND;SG;1;POS;PRS
skorce	skorce	N;NOM;SG
šija	šija	N;NOM;SG
vuapsahaine	vuapsahaine	N;ACC;SG
douhtor	douhtor	N;NOM;SG
grafin	grafin	N;ACC;SG
mečče	mečiči	N;PROL;PL
mečče	mecile	N;AT+ALL;PL
rohkei	rohkei	ADJ;NOM;SG
hangi	hangi	N;NOM;SG
barda	barda	N;ACC;SG
luzikk	luzikk	N;ACC;SG
orz’	orz’	N;NOM;SG
hopp	hopp	N;ACC;SG
paimenduskoht	paimenduskoht	N;ACC;SG
šebä	šebä	N;ACC;SG
ryndäz	ryndäz	N;ACC;SG
vuaksa	vuaksa	N;ACC;SG
burakk	burakk	N;NOM;SG
eväs	eväs	N;ACC;SG
škilette	škilette	N;ACC;SG
vederiste	vederiste	N;NOM;SG
čieppi	čieppi	N;NOM;SG
pirgaažed	pirgaažed	N;ACC;SG
očč	očč	N;ACC;SG
ahmuoi	ahmuoi	N;NOM;SG
sarvi	sarvi	N;ACC;SG
karte	karte	N;NOM;SG
pakottada	pakottau	V;IND;SG;3;POS;PRS
notkie	notkie	ADJ;NOM;SG
lämmin	lämmin	ADJ;NOM;SG
piili	piili	N;ACC;SG
siegl	siegl	N;ACC;SG
d’uged	d’uged	ADJ;ACC;SG
sier	sier	N;NOM;SG
biibal’	biibal’	N;NOM;SG
hyubi	hyubi	N;ACC;SG
čidži	čidži	N;ACC;SG
šug	šug	N;ACC;SG
rokka	rokka	N;NOM;SG
kirjutin	kirjutin	N;NOM;SG
kursad	kursad	N;NOM;PL
n’auguda	n’augun	V;IND;SG;1;POS;PRS
sroičč	sroičč	N;ACC;SG
koira	koira	N;ACC;SG
vuoži	vuoži	N;ACC;SG
maksa	maksa	N;ACC;SG
tungeda	tungen	V;IND;SG;1;POS;PRS
moni	Moned	PRO;NOM;PL
n’akut	n’akut	N;NOM;SG
uskonde	uskonde	N;NOM;SG
kylläine	kylläine	ADJ;ACC;SG
kylvämine	kylvämine	N;ACC;SG
svorčč	svorčč	N;ACC;SG
kuokk	kuokk	N;ACC;SG
Vaugedven’a	Vaugedven’a	PROPN;NOM;SG
valgedaine	valgedaine	N;ACC;SG
lambi	lambi	N;ACC;SG
lautt	lautt	N;ACC;SG
häi	häi	PRO;NOM;SG
kasse	kasse	N;ACC;SG
sihlik	sihlik	N;ACC;SG
laid	laid	N;NOM;SG
muzau	muzau	ADJ;ACC;SG
hiilavu	hiilavu	ADJ;ACC;SG
kyly	kylyd	N;PRT;SG
licei	licei	N;NOM;SG
p’atna	p’atna	N;ACC;SG
siime	siime	N;ACC;SG
piästada	piäzi	V;IPFV;IND;SG;3;POS;PST
vier	vier	N;NOM;SG
bumag	bumag	N;NOM;SG
senčuoi	senčuoi	N;NOM;SG
kord’	kord’	N;NOM;SG
liina	liina	N;NOM;SG
velg	velg	N;NOM;SG
pikkaraane	pikkaraane	ADJ;NOM;SG
siere	siere	N;NOM;SG
bezmeni	bezmeni	N;NOM;SG
kuoppe	kuoppe	N;NOM;SG
pehmed	pehmed	N;NOM;SG
ruuhi	ruuhi	N;ACC;SG
ukko	ukko	N;ACC;SG
veikuoi	veikuoi	N;ACC;SG
lomud	lomud	N;NOM;SG
vazarane	vazarane	N;NOM;SG
heine	heine	N;NOM;SG
bokke	bokke	N;NOM;SG
taloi	taloi	N;NOM;SG
kiäg	kiäg	N;NOM;SG
sanelu	sanelu	N;NOM;SG
tahtas	tahtas	N;NOM;SG
kurg	kurg	N;ACC;SG
löttö	löttö	N;NOM;SG
kuudamaine	kuudamaine	N;NOM;SG
hüübii	hüübii	N;NOM;SG
aspirant	aspirantad	N;NOM;PL
muiged	muiged	ADJ;NOM;SG
hudr	hudr	ADJ;NOM;SG
lieččida	liečin	V;IND;SG;1;POS;PRS
artteli	artteli	N;NOM;SG
verk	verk	N;ACC;SG
kävelemiine	kävelemiine	N;NOM;SG
čihko	čihko	N;NOM;SG
zor’a	zor’a	N;NOM;SG
šeba	šeba	N;ACC;SG
kandepiä	kandepiä	N;NOM;SG
däiččü	däiččü	N;ACC;SG
lähtä	lähted	V;IND;SG;2;POS;PRS
tabakka	tabakka	N;ACC;SG
muokke	muokke	N;ACC;SG
tahtoda	tahton	V;IND;SG;1;POS;PRS
rotte	rotte	N;ACC;SG
viesti	viesti	N;ACC;SG
koir	koir	N;ACC;SG
ruog	ruog	N;ACC;SG
sorz	sorz	N;ACC;SG
penger	penger	N;ACC;SG
pilkoda	pilkon	V;IND;SG;1;POS;PRS
vikateh	vikateh	N;ACC;SG
grib	gribad	N;PRT;SG
tagimane	tagimane	ADJ;NOM;SG
kases	kases	N;ACC;SG
kezakuu	kezakuu	N;ACC;SG
tatta	tatta	N;ACC;SG
ryginde	ryginde	N;NOM;SG
ruahtoveži	ruahtoveži	N;ACC;SG
hoppu	hoppu	N;ACC;SG
päčči	päčči	N;ACC;SG
sulg	sulg	N;NOM;SG
kiäbräine	kiäbräine	N;NOM;SG
äijäpäivä	äijäpäivä	N;ACC;SG
nähtä	nägen	V;IND;SG;1;POS;PRS
tyyryd	tyyryd	N;NOM;SG
čuaju	čuaju	N;ACC;SG
välle	välle	ADJ;ACC;SG
pehmie	pehmie	ADJ;ACC;SG
keldataudi	keldataudi	N;NOM;SG
käri	käri	N;NOM;SG
villa	villa	N;ACC;SG
artikkeli	artikkeli	N;NOM;SG
kofej	kofej	N;ACC;SG
grib	grib	N;ACC;SG
röččä	röččä	N;ACC;SG
tik	tik	N;ACC;SG
guba	guba	N;ACC;SG
ahav	ahav	N;ACC;SG
maikku	maikku	N;ACC;SG
halgo	halgo	N;ACC;SG
nižu	nižu	N;NOM;SG
mučakk	mučakk	N;NOM;SG
lahne	lahne	N;ACC;SG
starikke	starikke	N;ACC;SG
pacas	pacas	N;ACC;SG
kunut	kunut	N;NOM;SG
surjak	surjak	N;ACC;SG
herneh	hernehet	N;NOM;PL
batok	batok	N;ACC;SG
liipuoi	liipuoi	N;NOM;SG
sätt	sätt	N;ACC;SG
bard	bard	N;NOM;SG
lendel’tä	lendelen	V;IND;SG;1;POS;PRS
vuaks	vuaks	N;ACC;SG
sild	sild	N;NOM;SG
vüö	vüö	N;NOM;SG
pyhäpäiv	pyhäpäivän	N;BYWAY;SG
moleben	moleben	N;NOM;SG
posteli	posteli	N;NOM;SG
ušva	ušva	N;NOM;SG
ustav	ustav	N;NOM;SG
vihko	vihko	N;NOM;SG
seppe	seppe	N;NOM;SG
katuhke	katuhke	N;ACC;SG
opastai	opastai	N;NOM;SG
reig	reig	N;NOM;SG
ruble	ruble	N;ACC;SG
palgiž	palgiž	N;NOM;SG
ligo	ligo	N;NOM;SG
tabakke	tabakke	N;ACC;SG
honga	honga	N;NOM;SG
tallt	tallt	N;ACC;SG
lagi	lagi	N;ACC;SG
rungas	rungas	N;ACC;SG
lähtem	lähtem	N;ACC;SG
gostinč	gostinč	N;NOM;SG
hardijad	hardijad	N;NOM;SG
praud	praud	N;ACC;SG
riihi	riihi	N;NOM;SG
taina	taina	N;NOM;SG
süömine	süömine	N;NOM;SG
eraz	eraz	PRO;NOM;SG
abid	abid	N;NOM;SG
päivänlaskutuuli	päivänlaskutuuli	N;NOM;SG
sevoitar	sevoitar	N;NOM;SG
siärvärtinluu	siärvärtinluu	N;NOM;SG
tuačke	tuačke	N;ACC;SG
pühäpäi	pühäpäi	N;ACC;SG
staruha	staruha	N;ACC;SG
vahnembat	vahnembat	N;ACC;SG
kukšin	kukšin	N;ACC;SG
sused	sused	N;NOM;SG
nado	nado	N;NOM;SG
muam	muamod	N;PRT;SG
pagizii	pagizii	N;NOM;SG
virst	virst	N;NOM;SG
birda	birda	N;ACC;SG
rinda	rinda	N;NOM;SG
uglahin’e	uglahin’e	ADJ;ACC;SG
suolheine	suolheine	N;NOM;SG
tetradi	tetradi	N;NOM;SG
loim	loim	N;ACC;SG
suurin	suurin	N;NOM;SG
čura	čura	N;NOM;SG
počinpoige	počinpoige	N;NOM;SG
muam	muam	N;NOM;SG
udu	udu	N;ACC;SG
huba	huba	ADJ;ACC;SG
diäškuapp	diäškuapp	N;ACC;SG
laud	laud	N;ACC;SG
keijäine	keijäine	N;ACC;SG
iškim	iškim	N;ACC;SG
endžimaižar’g	endžimaižar’g	N;ACC;SG
särvi	särvi	N;ACC;SG
huole	huole	N;NOM;SG
emindäm	emindäm	N;ACC;SG
bird	bird	N;ACC;SG
krane	krane	N;NOM;SG
oleksendelda	oleksendelnu	V.PTCP;PRS;PASS
ken	ken	PRO;NOM;SG
tabata	tabadan	V;IND;SG;1;POS;PRS
ukazke	ukazke	N;ACC;SG
lužikk	lužikk	N;ACC;SG
händä	händä	N;ACC;SG
d’äiče	d’äiče	N;ACC;SG
pakkuli	pakkuli	N;ACC;SG
bank	bank	N;ACC;SG
mändü	mändü	N;NOM;SG
äges	äges	N;NOM;SG
ahaž	ahaž	ADJ;NOM;SG
tieduoinikk	tieduoinikk	N;NOM;SG
muamindam	muamindam	N;NOM;SG
aiže	aiže	N;ACC;SG
sormus	sormus	N;ACC;SG
remeni	remeni	N;ACC;SG
anket	anket	N;NOM;SG
sarafan	sarafan	N;ACC;SG
zaloške	zaloške	N;ACC;SG
zapas	zapas	N;ACC;SG
pala	pala	N;ACC;SG
hristosida	hristosin	V;IND;SG;1;POS;PRS
hämähäkk	hämähäkk	N;NOM;SG
azbukke	azbukke	N;ACC;SG
sestruoi	sestruoi	N;ACC;SG
vederist	vederist	N;ACC;SG
šild	šild	N;ACC;SG
kruuge	kruuge	N;NOM;SG
pal’aine	pal’aine	N;NOM;SG
puraz	puraz	N;NOM;SG
lešuoi	lešuoi	N;NOM;SG
taigin	taigin	N;ACC;SG
pakaine	pakaine	N;ACC;SG
sukkulaine	sukkulaine	N;ACC;SG
čubuhiiri	čubuhiiri	N;ACC;SG
d’uuri	d’uuret	N;NOM;PL
muilu	muilu	N;ACC;SG
prikaz	prikaz	N;ACC;SG
vajehtys	vajehtys	N;ACC;SG
čaju	čaju	N;NOM;SG
huondes	huondes	N;NOM;SG
diplom	diplom	N;ACC;SG
zaborke	zaborke	N;ACC;SG
ägä	ägä	N;ACC;SG
vaikku	vaikku	N;NOM;SG
pordimuoi	pordimuoi	N;NOM;SG
oruuža	oruuža	N;NOM;SG
kulakk	kulakk	N;ACC;SG
vahalauk	vahalauk	N;ACC;SG
pilida	pilin	V;IND;SG;1;POS;PRS
tuučče	tuučče	N;ACC;SG
buzat	buzat	N;NOM;SG
kyzyndlist	kyzyndlist	N;NOM;SG
tora	tora	N;ACC;SG
bapk	bapk	N;ACC;SG
soged	soged	ADJ;NOM;SG
keskškola	keskškola	N;ACC;SG
tüö	tüö	N;NOM;SG
uroz	uroz	N;NOM;SG
pičukkaine	pičukkaine	ADJ;ACC;SG
astuda	oližit astunu	V;PRF;COND;SG;2;POS;PRS
šittaböröi	šittaböröi	N;ACC;SG
korva	korva	N;ACC;SG
kadaja	kadaja	N;ACC;SG
osle	osle	N;ACC;SG
kuožali	kuožali	N;ACC;SG
nuad	nuad	PRO;NOM;SG
staršin	staršin	N;NOM;SG
maima	maima	N;NOM;SG
uuhut	uuhut	N;NOM;SG
lagevus	lagevus	N;NOM;SG
pajanik	pajanik	N;NOM;SG
arbuoitus	arbuoitus	N;NOM;SG
nurmi	nurmi	N;NOM;SG
uksi	uksi	N;NOM;SG
funta	funta	N;NOM;SG
ruškič	ruškič	N;NOM;SG
taza	taza	ADJ;ACC;SG
lötüö	lötüö	N;NOM;SG
grošše	grošše	N;NOM;SG
kande	kande	N;ACC;SG
mečkana	mečkana	N;ACC;SG
pyöryš	pyöryš	N;NOM;SG
sulaimie	sulaimie	N;ACC;SG
kuome	kuome	N;NOM;SG
rahtvezi	rahtvezi	N;ACC;SG
matkulaitos	matkulaitos	N;ACC;SG
kuoma	kuoma	N;NOM;SG
vel’l’	vel’l’	N;NOM;SG
lappalažet	lappalažet	N;NOM;SG
paimen	paimen	N;ACC;SG
solme	solme	N;NOM;SG
karandaš	karandaš	N;NOM;SG
suabre	suabre	N;NOM;SG
purn	purn	N;NOM;SG
stanke	stanke	N;ACC;SG
vihme	vihme	N;ACC;SG
čotte	čotte	N;NOM;SG
suobatt	suobatt	N;NOM;SG
pieluz	pieluz	N;NOM;SG
muroitez	muroitez	N;NOM;SG
pruažniekke	pruažniekke	N;NOM;SG
d’älge	d’älge	N;NOM;SG
astuda	en astu	V;IND;SG;1;NEG;PRS
eineh	eineh	N;ACC;SG
mukkada	mukkan	V;IND;SG;1;POS;PRS
voida	voidah	V;IND;PL;3;POS;PRS
kažinpoige	kažinpoige	N;NOM;SG
tabakk	tabakk	N;NOM;SG
ezmažar’g’	ezmažar’g’	N;NOM;SG
rotta	rotta	N;NOM;SG
randaine	randaine	N;NOM;SG
pel’gättädä	pel’gättän	V;IND;SG;1;POS;PRS
kalma	kalma	N;ACC;SG
kirjuttada	kirjutettu	V;PRF;IND;SG;3;POS;PST
süli	süli	N;NOM;SG
vuassa	vuassa	N;ACC;SG
turkki	turkki	N;ACC;SG
siegle	siegle	N;ACC;SG
kugaltahto	kugaltahto	PRO;NOM;SG
vačanke	vačanke	ADJ;ACC;SG
sogie	sogie	ADJ;ACC;SG
ruohke	ruohke	ADJ;NOM;SG
hengittädä	hengitan	V;IND;SG;1;POS;PRS
ajoš	ajoš	N;ACC;SG
kunič	kunič	N;ACC;SG
plet’t’i	plet’t’i	N;NOM;SG
suole	suole	N;ACC;SG
räkki	räkki	N;ACC;SG
salgo	salgo	N;ACC;SG
virgu	virgu	N;NOM;SG
musta	musta	ADJ;ACC;SG
lühüt	lühüt	ADJ;ACC;SG
goste	goste	N;ACC;SG
kuared	kuared	N;NOM;SG
stavinad	stavinad	N;NOM;SG
sija	sija	N;NOM;SG
orbuoi	orbuoi	N;NOM;SG
kovažin	kovažin	N;ACC;SG
kezuoi	kezuoite	N;PRT;SG
zalošk	zalošk	N;ACC;SG
ženih	ženih	N;NOM;SG
lešk	lešk	N;NOM;SG
nämä	nämä	PRO;NOM;PL
Natoi	Natoi	PROPN;ACC;SG
pahn, pahne	pahn	N;ACC;SG
mädähnä	mädähnä	N;NOM;SG
drožd’at	drožd’at	N;NOM;SG
kukuoi	kukuoi	N;NOM;SG
ikkuna	ikkuna	N;ACC;SG
svuattu	svuattu	N;NOM;SG
kazinpoiga	kazinpoiga	N;NOM;SG
tyrä	tyrä	N;NOM;SG
dorošk	dorošk	N;ACC;SG
vezi	vezi	N;ACC;SG
rubilöttö	rubilöttö	N;ACC;SG
VepKar - korpus	VepKar - korpus	N;ACC;SG
sülgi	sülgi	N;NOM;SG
hanhi	hanhi	N;ACC;SG
čainikke	čainikke	N;ACC;SG
astuda	älgätte astugat	V;IMP;PL;2;NEG
puol’	puol’	N;ACC;SG
liste	liste	N;NOM;SG
ainav	ainav	ADJ;NOM;SG
eht’	eht’	N;NOM;SG
pagišta	pagižen	V;IND;SG;1;POS;PRS
tuulas	tuulas	N;NOM;SG
üs’k	üs’k	N;NOM;SG
ilm	ilm	N;NOM;SG
opastuda	opastun	V;IND;SG;1;POS;PRS
lahga	lahga	N;ACC;SG
zvone	zvone	N;ACC;SG
bank	bankaspiä	N;IN+ABL;SG
suvi	suvi	ADJ;ACC;SG
droškad	droškad	N;NOM;PL
kieletyöi	kieletyöi	ADJ;NOM;SG
aganod	aganod	N;NOM;SG
kumi	kumi	N;NOM;SG
vüödrüs	vüödrüs	N;NOM;SG
ižände	ižände	N;ACC;SG
siä	siä	N;ACC;SG
kriške	kriške	N;ACC;SG
viest’	viest’	N;NOM;SG
vieha	vieha	N;NOM;SG
nagriž	nagriž	N;ACC;SG
talme	talme	N;ACC;SG
lammas	lammas	N;ACC;SG
polatti	polatti	N;ACC;SG
häkyttäi	häkyttäi	N;ACC;SG
šieglanpiälüzet	šieglanpiälüzet	N;NOM;SG
ogas	ogas	N;NOM;SG
ezmäžargi	ezmäžargi	N;NOM;SG
tagapuoliluu	tagapuoliluu	N;NOM;SG
lappe	lappe	N;ACC;SG
tahtoda	tahtou	V;IND;SG;3;POS;PRS
virste	virste	N;NOM;SG
piha	pihal	N;AT+ESS;SG
viina	viina	N;NOM;SG
uhku	uhku	N;ACC;SG
mimmoine	mimmoine	PRO;ACC;SG
airo	airo	N;NOM;SG
nivel	nivel	N;NOM;SG
kihurat	kihurat	N;NOM;SG
astuda	ei astuttaiš	V;COND;PL;3;NEG;PRS
armotoin	armotoin	N;ACC;SG
vihaline	vihaline	ADJ;NOM;SG
kord’	kord’	N;ACC;SG
astuda	astužin	V;COND;SG;1;POS;PRS
dälgimaine	dälgimaine	ADJ;NOM;SG
löytä	löydan	V;IND;SG;1;POS;PRS
kuored	kuored	N;NOM;SG
olgopiä	olgopiä	N;NOM;SG
vier	vier	N;ACC;SG
lyydilaine	lyydilaine	N;NOM;SG
vägev	vägev	ADJ;ACC;SG
kirjutus	kirjutus	N;NOM;SG
mečče	mečät	N;NOM;PL
t’yuni	t’yuni	ADJ;NOM;SG
haižu	haižu	N;NOM;SG
mimmoine	mimmoine	PRO;NOM;SG
aig	aig	N;NOM;SG
abai	abai	N;ACC;SG
piivo	piivo	N;ACC;SG
čupp	čupp	N;ACC;SG
onduz	onduz	N;NOM;SG
kida	kida	N;ACC;SG
löttö	löttö	N;ACC;SG
lehenkanda	lehenkanda	N;ACC;SG
niken	niken	PRO;NOM;SG
aktivine	aktivine	ADJ;NOM;SG
trezvuoi	trezvuoi	ADJ;NOM;SG
lugend	lugendad	N;NOM;PL
kauzi	kauzi	N;NOM;SG
viizaš	viizaš	ADJ;NOM;SG
mečče	mečäd	N;NOM;PL
andada	andan	V;IND;SG;1;POS;PRS
varuo	varuo	N;ACC;SG
ard	ard	N;ACC;SG
pöččö	pöččö	N;ACC;SG
komša	komša	N;NOM;SG
akademii	akademii	N;NOM;SG
gurbe	gurbe	N;NOM;SG
hebočaine	hebočaine	N;NOM;SG
välle	välle	ADJ;NOM;SG
kaččoda	kaččou	V;IND;SG;3;POS;PRS
tark	tark	ADJ;ACC;SG
dügie	dügie	ADJ;NOM;SG
rauh	rauh	N;NOM;SG
pakičus	pakičus	N;NOM;SG
kaži	kažiin	N;GEN;PL
kuiv	kuiv	ADJ;NOM;SG
šängi	šängi	N;ACC;SG
viha	viha	ADJ;NOM;SG
röhkädä	röhkän	V;IND;SG;1;POS;PRS
vahahine	vahahine	N;NOM;SG
kuašše	kuašše	N;ACC;SG
olda	oližitte	V;COND;PL;2;POS;PRS
ryginde	ryginde	N;ACC;SG
koditoi	koditoi	ADJ;NOM;SG
slabuu	slabuu	ADJ;ACC;SG
muu	muid	ADJ;PRT;PL
pohd’a	pohd’a	N;NOM;SG
starikka	starikka	N;NOM;SG
ris	ris	N;ACC;SG
heboč	heboč	N;NOM;SG
šulkkuine	šulkkuine	ADJ;ACC;SG
käri	käri	N;ACC;SG
keldataudi	keldataudi	N;ACC;SG
habukka	habukka	N;ACC;SG
ounastada	ounastan	V;IND;SG;1;POS;PRS
šüvä	šüvä	ADJ;ACC;SG
sobat	sobat	N;NOM;SG
koruoi	koruoi	N;NOM;SG
mel’onke	mel’onke	N;NOM;SG
bezmen	bezmen	N;NOM;SG
mučakk	mučakk	N;ACC;SG
türü	türü	N;NOM;SG
sangi	sangi	N;NOM;SG
paltin	paltin	N;ACC;SG
luistelupeld	luistelupeld	N;ACC;SG
murdo	murdo	N;ACC;SG
doske	doske	N;ACC;SG
ristrihme	ristrihme	N;ACC;SG
elävä	elävä	ADJ;NOM;SG
toahitukku	toahitukku	N;NOM;SG
ligakas	ligakas	ADJ;NOM;SG
keridä	kerin	V;IND;SG;1;POS;PRS
ušva	ušva	N;ACC;SG
ustav	ustav	N;ACC;SG
odejal	odejal	N;NOM;SG
aitt	aitt	N;ACC;SG
palkka	palkka	N;NOM;SG
funte	funte	N;NOM;SG
vahalaukoi	vahalaukoi	N;NOM;SG
minä	minud	PRO;ACC;SG
mečče	mecas	N;IN+ESS;SG
orav	orav	N;ACC;SG
moleben	moleben	N;ACC;SG
vihko	vihko	N;ACC;SG
pyhtidäkseh	pyhtimmös	V;IND;SG;1;POS;PRS;REFL
seppe	seppe	N;ACC;SG
mehäine	mehäine	N;ACC;SG
hyö	hyö	PRO;NOM;SG
sydänkeräžet	sydänkeräžet	N;ACC;SG
kogo	kogo	N;ACC;SG
kieža	kieža	N;ACC;SG
kaftan	kaftan	N;ACC;SG
buaba	buaba	N;ACC;SG
hyväroduine	hyväroduine	ADJ;NOM;SG
kablas	kablas	N;NOM;SG
uidai	uidai	N;NOM;SG
helme	helme	N;NOM;SG
čistida	čistin	V;IND;SG;1;POS;PRS
monid’atažihine	monid’atažihine	ADJ;ACC;SG
kezuoi	kezuoi	N;ACC;SG
surma	surma	N;NOM;SG
černiläd	černiläd	N;NOM;SG
kang	kang	N;NOM;SG
kebie	kebie	ADJ;ACC;SG
suol	suol	N;NOM;SG
šukka	šukka	N;NOM;SG
regä	regä	N;NOM;SG
taina	taina	N;ACC;SG
riihi	riihi	N;ACC;SG
kulu	kulu	ADJ;NOM;SG
kaži	kažin	N;ACC;SG
homm	hommad	N;NOM;PL
muila	muila	N;NOM;SG
dverčikät	dverčikät	N;NOM;PL
kodi	kodin	N;ACC;SG
skorce	skorce	N;ACC;SG
linn	linn	N;ACC;SG
šiärvärttin	šiärvärttin	N;NOM;SG
rinda	rinda	N;ACC;SG
tetradi	tetradi	N;ACC;SG
huogastuda	huogastun	V;IND;SG;1;POS;PRS
suolheine	suolheine	N;ACC;SG
ainuoi	ainuoi	ADJ;ACC;SG
kovera	kovera	ADJ;ACC;SG
pappi	pappi	N;ACC;SG
tuttau	tuttau	ADJ;ACC;SG
leppä	leppä	N;ACC;SG
pl’en	pl’en	N;ACC;SG
kukkaro	kukkaro	N;ACC;SG
riähkävydä	riähkävyn	V;IND;SG;1;POS;PRS
heimokunda	heimokunda	N;NOM;SG
ruogačču	ruogačču	N;NOM;SG
kokka	kokka	N;NOM;SG
bazar	bazaril	N;AT+ESS;SG
astuda	olimme astunu	V;PRF;IND;PL;1;POS;PST
kuarzin	kuarzin	N;ACC;SG
keruo	keruo	N;ACC;SG
brigadir	brigadir	N;ACC;SG
sihililik	sihililik	N;ACC;SG
pada	pada	N;ACC;SG
kartinke	kartinke	N;NOM;SG
piihtet	piihtet	N;ACC;SG
höšte	höšte	N;NOM;SG
reng	reng	N;NOM;SG
mučuoi	mučuoi	N;ACC;SG
tuli	tuli	N;NOM;SG
työndamiine	työndamiine	N;NOM;SG
soitand	soitand	N;NOM;SG
kego	kego	N;NOM;SG
mečče	mečiden	N;GEN;PL
čakkavo	čakkavo	N;NOM;SG
ozre	ozre	N;ACC;SG
künzi	künzi	N;NOM;SG
ruadomatk	ruadomatk	N;NOM;SG
höštekogo	höštekogo	N;NOM;SG
luhtu	luhtu	N;NOM;SG
bošši	bošši	N;NOM;SG
voibruusoi	voibruusoi	N;NOM;SG
bual	bual	N;NOM;SG
šitböröi	šitböröi	N;NOM;SG
tagaraivo	tagaraivo	N;NOM;SG
virsta	virsta	N;ACC;SG
kuolta	kuolen	V;IND;SG;1;POS;PRS
poštukartočk	poštukartočk	N;NOM;SG
svuad’b	svuad’b	N;ACC;SG
selgüs	selgüs	N;ACC;SG
kierd	kierd	N;ACC;SG
tuhke	tuhke	N;NOM;SG
keruoi	keruoi	N;NOM;SG
aho	aho	N;NOM;SG
lähtedä	lähti	V;IPFV;IND;SG;3;POS;PST
koččuri	koččuri	N;NOM;SG
viine	viine	N;NOM;SG
Anus	Anuksehe	PROPN;IN+ALL;SG
maks	maks	N;ACC;SG
emähebo	emähebo	N;ACC;SG
lape	lape	N;ACC;SG
puazu	puazu	N;NOM;SG
kaik	kaikis	PRO;IN+ABL;SG
ruavas	ruavas	ADJ;NOM;SG
nel’lanpäiv	nel’lanpäivän	N;BYWAY;SG
storož	storožan	N;ACC;SG
d’og	d’og	N;NOM;SG
uhk	uhk	N;NOM;SG
večerni	večerni	N;NOM;SG
šeibäz	šeibäz	N;NOM;SG
firkaida	firkain	V;IND;SG;1;POS;PRS
halgaita	halgaidan	V;IND;SG;1;POS;PRS
grammatik	grammatikkad	N;PRT;SG
palane	palane	N;ACC;SG
ainu	ainu	ADJ;ACC;SG
pruaznikk	pruaznikk	N;NOM;SG
iduoine	iduoine	N;NOM;SG
vahnembad	vahnembad	N;NOM;SG
korž	korž	N;NOM;SG
astuda	olit astunu	V;PRF;IND;SG;2;POS;PST
dialekt	dialektal	N;AT+ESS;SG
laihina	laihina	N;ACC;SG
zavesi	zavesi	N;ACC;SG
šiegl	šiegl	N;ACC;SG
ne	ne	PRO;NOM;SG
olda	olimme	V;IPFV;IND;PL;1;POS;PST
variš	variš	N;ACC;SG
nimipäiväd	nimipäiväd	N;NOM;PL
taloi	taloi	N;ACC;SG
bokke	bokke	N;ACC;SG
ambund	ambund	N;NOM;SG
lugeda	lugimme	V;IPFV;IND;PL;1;POS;PST
kibu	kibu	N;NOM;SG
kiäg	kiäg	N;ACC;SG
vägi	vägi	N;ACC;SG
lapsi	lapsiden	N;ACC;SG
veäre	veäre	ADJ;NOM;SG
parahin	parahin	ADJ;NOM;SG
keng	kengäd	N;NOM;PL
tera	tera	N;NOM;SG
ženihhe	ženihhe	N;ACC;SG
astiit	astiit	N;NOM;SG
oruuža	oruuža	N;ACC;SG
rouge	rouge	N;ACC;SG
čigištä	čigižeu	V;IND;SG;3;POS;PRS
hein	hein	N;NOM;SG
udžve	udžve	N;ACC;SG
kudoda	kudon	V;IND;SG;1;POS;PRS
n’umal	n’umal	N;ACC;SG
koivu	koivu	N;ACC;SG
kylläine	kylläine	ADJ;NOM;SG
työtä	työndän	V;IND;SG;1;POS;PRS
loma	loma	N;ACC;SG
astuda	lienemme astunu	V;PRF;POT;PL;1;POS;PRS
kuudamaine	kuudamaine	N;ACC;SG
čihva	čihva	N;NOM;SG
ižä	ižä	N;ACC;SG
loituoine	loituoine	ADJ;NOM;SG
idone	idone	N;NOM;SG
sdavaida	sdavain	V;IND;SG;1;POS;PRS
seledit	seledit	N;NOM;SG
universitet	universitet	N;NOM;SG
olda	oled	V;IND;SG;2;POS;PRS
verbl’ude	verbl’ude	N;ACC;SG
oma	oma	PRO;ACC;SG
sia	sia	PRO;ACC;SG
sin’ke	sin’ke	N;NOM;SG
zuakkuna	zuakkuna	N;ACC;SG
nuotte	nuotte	N;NOM;SG
mecc	mecc	N;NOM;SG
grošše	grošše	N;ACC;SG
lötüö	lötüö	N;ACC;SG
peldo	peldod	N;NOM;PL
honguoi	honguoi	N;ACC;SG
pyöryš	pyöryš	N;ACC;SG
kuome	kuome	N;ACC;SG
arge	arge	ADJ;NOM;SG
kraske	kraske	N;NOM;SG
liägär’	liägär’	N;NOM;SG
oiged	oiged	ADJ;NOM;SG
keskus	keskus	N;ACC;SG
tiinu	tiinu	N;ACC;SG
lidna	lidna	N;NOM;SG
glavnuoi	glavnuoi	ADJ;ACC;SG
ebävoimas	ebävoimas	N;NOM;SG
havado	havado	N;NOM;SG
purn	purn	N;ACC;SG
huondez	huondez	N;ACC;SG
solme	solme	N;ACC;SG
suabre	suabre	N;ACC;SG
vepsad	vepsad	N;ACC;SG
liivaz	liivaz	N;ACC;SG
kaide	kaide	ADJ;NOM;SG
astuda	astužit	V;COND;SG;2;POS;PRS
pruažniekke	pruažniekke	N;ACC;SG
stokan	stokan	N;ACC;SG
tain	tain	N;ACC;SG
d’oučen	d’oučen	N;NOM;SG
höštötukku	höštötukku	N;NOM;SG
kirguda	kirgun	V;IND;SG;1;POS;PRS
Krissan	Krissan	PROPN;NOM;SG
suomelaine	suomelaine	N;ACC;SG
kondie	kondie	N;ACC;SG
liedehm	liedehm	N;ACC;SG
ainag	ainag	ADJ;ACC;SG
kindet	kindet	ADJ;ACC;SG
lühüt	lühüt	ADJ;NOM;SG
programme	programme	N;ACC;SG
koilline	koilline	N;ACC;SG
kona	kona	N;NOM;SG
küühküine	küühküine	N;NOM;SG
sčokka	sčokka	N;NOM;SG
kartt	kartt	N;NOM;SG
ruocid	ruocid	N;NOM;SG
harde	harde	N;NOM;SG
šiželihhe	šiželihhe	N;NOM;SG
vaiget	vaiget	ADJ;ACC;SG
šiegla	šiegla	N;NOM;SG
kylvädä	kylvän	V;IND;SG;1;POS;PRS
tulehmo	tulehmo	N;ACC;SG
kall’	kall’	N;ACC;SG
aida	aida	N;NOM;SG
šulkku	šulkku	N;ACC;SG
pas’s’iboita	pas’s’iboičen	V;IND;SG;1;POS;PRS
stroju	stroju	N;ACC;SG
čihuoi	čihuoi	N;ACC;SG
d’oukko	d’oukko	N;ACC;SG
siärvärtinluu	siärvärtinluu	N;ACC;SG
päivänlaskutuuli	päivänlaskutuuli	N;ACC;SG
sevoitar	sevoitar	N;ACC;SG
očkad	očkad	N;NOM;PL
abid	abid	N;ACC;SG
miel’	mieled	N;PRT;SG
keldaine	keldaine	ADJ;NOM;SG
minä	minun	PRO;GEN;SG
salat’t’i	salat’t’i	N;ACC;SG
tačme	tačme	N;NOM;SG
plet’t’i	plet’t’i	N;ACC;SG
lahnanparuliine	lahnanparuliine	N;NOM;SG
merkičus	merkičukses	N;IN+ESS;SG
val’l’astus	val’l’astus	N;NOM;SG
pruadied	pruadied	N;NOM;SG
tirpada	tirpan	V;IND;SG;1;POS;PRS
maged	maged	ADJ;NOM;SG
korgie	korgie	ADJ;NOM;SG
paharubi	paharubi	N;NOM;SG
sarahpana	sarahpana	N;NOM;SG
orbuoi	orbuoi	N;ACC;SG
üöleloi	üöleloi	N;ACC;SG
laska	laska	N;ACC;SG
pränikke	pränikke	N;ACC;SG
rahat	rahat	N;NOM;SG
mal’l’	mal’l’	N;NOM;SG
raid	raid	N;ACC;SG
jantari	jantari	N;ACC;SG
kuared	kuared	N;ACC;SG
turme	turme	N;NOM;SG
pualikk	pualikk	N;ACC;SG
stavinad	stavinad	N;ACC;SG
druuge	druuge	N;ACC;SG
suališ	suališ	N;ACC;SG
hoidai	hoidai	N;ACC;SG
ystävy	ystävy	N;NOM;SG
veži	veži	N;ACC;SG
koufkuot	koufkuot	N;NOM;SG
värnik	värnik	ADJ;ACC;SG
uho	uho	N;ACC;SG
lineike	lineike	N;ACC;SG
kuva	kuvad	N;PRT;SG
äig	äig	N;ACC;SG
hudre	hudre	ADJ;ACC;SG
muste	muste	ADJ;ACC;SG
muamuuroi	muamuuroi	N;NOM;SG
maime	maime	N;NOM;SG
mädähnä	mädähnä	N;ACC;SG
sualine	sualine	N;ACC;SG
rikat	rikat	N;NOM;SG
kauhtan	kauhtan	N;ACC;SG
ualdo	ualdo	N;ACC;SG
pulčukk	pulčukk	N;ACC;SG
kazinpoiga	kazinpoiga	N;ACC;SG
tyrä	tyrä	N;ACC;SG
kaimoul	kaimoul	N;ACC;SG
ostai	ostai	N;NOM;SG
pahn, pahne	pahn	N;NOM;SG
šiäri	šiäri	N;NOM;SG
kiitos	kiitos	N;NOM;SG
ozr	ozr	N;ACC;SG
ebävoimus	ebävoimus	N;ACC;SG
funtte	funtte	N;ACC;SG
tožnarg	tožnarg	N;ACC;SG
ruda	ruda	N;ACC;SG
omblii	omblii	N;ACC;SG
pohde	pohde	N;NOM;SG
karrk	karrk	N;NOM;SG
rokke	rokke	N;NOM;SG
apar	apar	N;ACC;SG
siived	siived	N;ACC;SG
lugeda	lugen	V;IND;SG;1;POS;PRS
zoahari	zoahari	N;ACC;SG
mama	mama	N;ACC;SG
pezä	pezä	N;ACC;SG
liäve	liäväs	N;IN+ESS;SG
oraane	oraane	N;ACC;SG
valged	valgedat	ADJ;NOM;PL
kebjed	kebjed	ADJ;NOM;SG
pačaz	pačaz	N;NOM;SG
kuččuda	kučun	V;IND;SG;1;POS;PRS
luomi	luomi	N;ACC;SG
zabottidakseh	zabotimmos	V;IND;SG;1;POS;PRS;REFL
kruuge	kruuge	N;ACC;SG
pal’aine	pal’aine	N;ACC;SG
salme	salme	N;NOM;SG
jubke	jubke	N;ACC;SG
silmät	silmät	N;ACC;SG
vedehine	vedehine	N;ACC;SG
etaž	etaž	N;ACC;SG
ärie	ärie	ADJ;NOM;SG
žiivatt	žiivatt	N;NOM;SG
suurima	suurima	N;NOM;SG
kihurat	kihurat	N;ACC;SG
pätne	pätne	N;NOM;SG
hein’kuu	hein’kuu	N;ACC;SG
polovikke	polovikke	N;ACC;SG
hukk	hukk	N;ACC;SG
hubaine	hubaine	ADJ;NOM;SG
ikr	ikr	N;ACC;SG
poklon	poklon	N;ACC;SG
lamppe	lamppe	N;NOM;SG
kiime	kiime	N;ACC;SG
pövü	pövü	N;NOM;SG
sumb	sumb	ADJ;ACC;SG
arga	arga	ADJ;NOM;SG
kobra	kobra	N;ACC;SG
räččinä	räččinä	N;NOM;SG
leht	lehted	N;PRT;SG
haižu	haižu	N;ACC;SG
kadai	kadai	N;NOM;SG
heimo	heimo	N;NOM;SG
tošargi	tošargi	N;NOM;SG
olgopiä	olgopiä	N;ACC;SG
kuored	kuored	N;ACC;SG
kaza	kaza	N;NOM;SG
müö	meil	PRO;AT+ESS;PL
mua	mua	N;NOM;SG
šelguoine	šelguoine	N;NOM;SG
uveh	uveh	N;NOM;SG
perti	perti	N;NOM;SG
lähine	lähine	ADJ;ACC;SG
čaj	čaj	N;ACC;SG
kringeli	kringeli	N;ACC;SG
žiivatta	žiivatta	N;ACC;SG
diedo	diedo	N;NOM;SG
bokka	bokka	N;ACC;SG
mužikk	mužikk	N;NOM;SG
tilkku	tilkku	N;ACC;SG
ahven	ahven	N;NOM;SG
näp	näp	N;NOM;SG
dengat	dengat	N;NOM;SG
ruškič	ruškič	N;ACC;SG
funta	funta	N;ACC;SG
tilku	tilku	N;NOM;SG
aide	aide	N;NOM;SG
šulkkuine	šulkkuine	ADJ;NOM;SG
šitt	šitt	N;NOM;SG
kart	kart	N;NOM;SG
kürzä	kürzä	N;ACC;SG
neidine	neidine	N;NOM;SG
taba	taba	N;NOM;SG
itkettäjö	itkettäjö	N;NOM;SG
tämä	täl	PRO;AT+ESS;SG
platform	platform	N;ACC;SG
püštände	püštände	N;ACC;SG
ohd’aksed	ohd’aksed	N;ACC;SG
lapsiinpert’	lapsiinpert’	N;NOM;SG
kolmašpäiv	kolmašpäiv	N;ACC;SG
uni	uni	N;ACC;SG
aptek	aptek	N;NOM;SG
käveltä	kävelen	V;IND;SG;1;POS;PRS
sup	sup	N;NOM;SG
dyrk	dyrk	ADJ;ACC;SG
tagaliine	tagaliine	ADJ;NOM;SG
liige	liige	ADJ;ACC;SG
kuzimuuruoi	kuzimuuruoi	N;ACC;SG
mielikaz	mielikaz	ADJ;NOM;SG
sudne	sudne	N;NOM;SG
reuna	reuna	N;ACC;SG
plotin	plotin	N;ACC;SG
hiihtäi	hiihtäi	N;ACC;SG
liuhe	liuhe	N;NOM;SG
česti	česti	N;ACC;SG
kunnetahto	kunnetahto	PRO;NOM;SG
semestr	semestr	N;NOM;SG
miehad	miehad	N;NOM;SG
länge	länge	N;ACC;SG
toukka	toukka	N;ACC;SG
kanttez	kanttez	N;ACC;SG
vadnas	vadnas	N;NOM;SG
lautta	lautta	N;NOM;SG
kakač	kakač	N;NOM;SG
niemi	niemi	N;NOM;SG
kovažima	kovažima	N;ACC;SG
äijä	äijä	ADJ;NOM;SG
bunukku	bunukku	N;ACC;SG
luoda	luon	V;IND;SG;1;POS;PRS
däred	däred	ADJ;ACC;SG
ristittü	ristittü	N;ACC;SG
laukk	laukk	N;NOM;SG
mus’tuoi	mus’tuoi	N;NOM;SG
izr	izr	N;NOM;SG
astuda	ei oldaiš astuttu	V;PRF;COND;PL;3;NEG;PRS
arvoitus	arvoitus	N;NOM;SG
haugi	haugi	N;NOM;SG
siig	siig	N;NOM;SG
kirves	kirves	N;NOM;SG
lod’ma	lod’ma	N;NOM;SG
vederistem	vederistem	N;NOM;SG
muila	muila	N;ACC;SG
lohkuoit	lohkuoit	N;ACC;SG
duomuoi	duomuoi	N;NOM;SG
taluoi	taluoid	N;NOM;PL
černiläd	černiläd	N;ACC;SG
kiške	kiške	N;ACC;SG
surma	surma	N;ACC;SG
kürze	kürze	N;ACC;SG
kuivakala	kuivakala	N;ACC;SG
gruhuo	gruhuo	ADJ;NOM;SG
kantes	kantes	N;NOM;SG
buukita	buukičen	V;IND;SG;1;POS;PRS
starik	starik	N;ACC;SG
policii	policii	N;ACC;SG
märge	märge	ADJ;NOM;SG
kehno	kehno	ADJ;NOM;SG
televizor	televizorad	N;PRT;SG
kokka	kokka	N;ACC;SG
perzeluu	perzeluu	N;NOM;SG
punaldus	punaldus	N;ACC;SG
lukk	lukk	N;NOM;SG
staruuha	staruuha	N;NOM;SG
suatto	suatto	N;NOM;SG
kuivekala	kuivekala	N;ACC;SG
ödönöi	ödönöi	N;ACC;SG
kagr	kagr	N;NOM;SG
čiučui	čiučui	N;NOM;SG
pimei	pimei	ADJ;NOM;SG
puhtas	puhtas	ADJ;NOM;SG
čuasut	čuasut	N;ACC;SG
uulič	uulič	N;ACC;SG
höstö	höstö	N;NOM;SG
rikos	rikos	N;NOM;SG
zakona	zakona	N;NOM;SG
haug	haug	N;NOM;SG
kudai	kudai	PRO;ACC;SG
d’uoksemiine	d’uoksemiine	N;NOM;SG
korv	korv	N;ACC;SG
trupke	trupke	N;ACC;SG
anza	anza	N;NOM;SG
tajembaine	tajembaine	ADJ;ACC;SG
keitandpert’	keitandpert’	N;NOM;SG
adiv	adiv	N;NOM;SG
huttu	huttu	N;NOM;SG
uskomiine	uskomiine	N;NOM;SG
maksada	maksan	V;IND;SG;1;POS;PRS
mužikka	mužikka	N;NOM;SG
Pyhärvi	Pyhärvi	PROPN;ACC;SG
vieha	vieha	N;ACC;SG
kasunuoraine	kasunuoraine	N;ACC;SG
püü	püü	N;ACC;SG
prawda	prawda	N;NOM;SG
vunukka	vunukka	N;NOM;SG
očča	očča	N;NOM;SG
edahaliine	edahaliine	ADJ;ACC;SG
yökluub	yökluub	N;ACC;SG
ezmäžargi	ezmäžargi	N;ACC;SG
virzut	virzut	N;ACC;SG
kormane	kormane	N;ACC;SG
ogas	ogas	N;ACC;SG
ola	ola	N;NOM;SG
tagapuoliluu	tagapuoliluu	N;ACC;SG
kihlat	kihlat	N;NOM;SG
keza	keza	N;ACC;SG
gazette	gazette	N;NOM;SG
vahačut	vahačut	N;NOM;SG
salgamo	salgamo	N;NOM;SG
funt	funt	N;NOM;SG
rohked	rohked	ADJ;NOM;SG
muloine	Muloižel	ADJ;AT+ESS;SG
puazu	puazu	N;ACC;SG
hango	hango	N;NOM;SG
karjalaine	karjalaine	N;NOM;SG
čaju	čajud	N;PRT;SG
kärpüöi	kärpüöi	N;ACC;SG
rüžä	rüžä	N;NOM;SG
čabero	čabero	N;NOM;SG
doroga	doroga	N;ACC;SG
pölü	pölü	N;ACC;SG
täin	täin	N;NOM;SG
keričii	keričii	N;NOM;SG
oraine	oraine	N;NOM;SG
harmua	harmua	ADJ;NOM;SG
pora	pora	N;NOM;SG
vedo	vedo	N;NOM;SG
pinda	pinda	N;NOM;SG
ležanke	ležanke	N;NOM;SG
kuld	kuld	N;NOM;SG
ildaine	ildaine	N;NOM;SG
kibedahiine	kibedahiine	ADJ;ACC;SG
appi	appi	N;NOM;SG
kaftana	kaftana	N;NOM;SG
kirjutus	kirjutus	N;ACC;SG
pärpäčč	pärpäčč	N;NOM;SG
air	air	N;NOM;SG
šüli	šüli	N;NOM;SG
tämä	tämäkši	PRO;TRANS;SG
ruadomatk	ruadomatkas	N;IN+ESS;SG
pagišta	pagižou	V;IND;SG;3;POS;PRS
hudra	hudra	ADJ;ACC;SG
olda	oli	V;IPFV;IND;SG;3;POS;PST
karjalad	karjalad	N;NOM;SG
tagimaine	tagimaine	ADJ;NOM;SG
ruata	ruadau	V;IND;SG;3;POS;PRS
jazi	jazi	N;NOM;SG
muigei	muigei	ADJ;ACC;SG
vuaru	vuaru	N;NOM;SG
aig	aig	N;ACC;SG
salmago	salmago	N;NOM;SG
bes’od	bes’od	N;NOM;SG
kuačku	kuačku	N;NOM;SG
höuhen	höuhen	N;NOM;SG
kell	kell	N;NOM;SG
taimen	taimen	N;NOM;SG
barbas	barbas	N;NOM;SG
badminton	badminton	N;NOM;SG
postel’nikke	postel’nikke	N;NOM;SG
ludeg	ludeg	N;NOM;SG
koht	kohtad	N;NOM;PL
adra	adra	N;NOM;SG
vahn	vahn	ADJ;NOM;SG
nakažida	nakažin	V;IND;SG;1;POS;PRS
ištuda	ištun	V;IND;SG;1;POS;PRS
sukka	sukka	N;ACC;SG
lühüd	lühüd	ADJ;NOM;SG
vihmuda	vihmuu	V;IND;SG;3;POS;PRS
astuda	oli astunu	V;PRF;IND;SG;3;POS;PST
vasta	vasta	N;NOM;SG
enzimäšargi	enzimäšargi	N;ACC;SG
päiv	päiväl	N;AT+ESS;SG
kird’ane	kird’ane	N;ACC;SG
ongiruaga	ongiruaga	N;ACC;SG
moine	moine	ADJ;ACC;SG
vihaline	vihaline	ADJ;ACC;SG
stuaroste	stuaroste	N;ACC;SG
kana	kana	N;ACC;SG
meččä	meččä	N;ACC;SG
šumu	šumu	N;ACC;SG
vlasti	vlasti	N;ACC;SG
pühä	pühä	N;NOM;SG
mieletyöi	mieletyöi	ADJ;ACC;SG
hörčče	hörčče	N;NOM;SG
valda	valda	N;NOM;SG
kraske	kraske	N;ACC;SG
liägär’	liägär’	N;ACC;SG
rainivo	rainivo	N;ACC;SG
havado	havado	N;ACC;SG
žurnalist	žurnalist	N;ACC;SG
paha	paha	N;NOM;SG
gos’t’	gos’t’	N;NOM;SG
hände	hände	N;NOM;SG
bobr	bobr	N;NOM;SG
slifkad	slifkad	N;NOM;SG
kouhkuoi	kouhkuoi	N;NOM;SG
kebjed	kebjed	ADJ;ACC;SG
d’änyöi	d’änyöi	N;NOM;SG
rauhe	rauhe	N;NOM;SG
rukk	rukk	N;ACC;SG
struuge	struuge	N;ACC;SG
taidelii	taidelii	N;ACC;SG
kard’alaine	kard’alaine	N;NOM;SG
aščat	aščat	N;NOM;SG
sadu	sadu	N;NOM;SG
liiga	liiga	ADJ;ACC;SG
kaik	kaik	PRO;NOM;SG
kurikk	kurikk	N;NOM;SG
rubl’a	rubl’a	N;NOM;SG
höštötukku	höštötukku	N;ACC;SG
heboč	heboč	N;ACC;SG
orla	orla	N;NOM;SG
ruaht	ruaht	N;NOM;SG
pehozet	pehozet	N;NOM;SG
vihanda	vihanda	ADJ;ACC;SG
dälgmääne	dälgmääne	ADJ;ACC;SG
kuldaine	kuldaine	ADJ;NOM;SG
vaugedven’alaine	vaugedven’alaine	N;NOM;SG
lappalaižet	lappalaižet	N;NOM;SG
jamščikke	jamščikke	N;ACC;SG
turba	turba	N;ACC;SG
minä	minut	PRO;ACC;PL
ketut	ketut	N;ACC;SG
ristikanz	ristikanzad	N;NOM;PL
bumaage	bumaage	N;NOM;SG
lat’t’i	lat’t’i	N;NOM;SG
voimatomahhoidai	voimatomahhoidai	N;NOM;SG
orih	orih	N;ACC;SG
säüne	säüne	N;ACC;SG
elaige	elaige	N;ACC;SG
sängi	sängi	N;ACC;SG
pedai	pedai	N;NOM;SG
znakke	znakke	N;ACC;SG
ajand	ajand	N;NOM;SG
kabrastada	kabrastan	V;IND;SG;1;POS;PRS
kyly	kyly	N;NOM;SG
hudre	hudre	ADJ;NOM;SG
val’l’astus	val’l’astus	N;ACC;SG
pruadied	pruadied	N;ACC;SG
oza	oza	N;ACC;SG
bembelö	bembelö	N;NOM;SG
havad	havad	N;NOM;SG
tsari	tsari	N;NOM;SG
mägi	mägi	N;ACC;SG
lapsi	lapsen	N;FRML;SG
korpus	korpus	N;ACC;SG
Norja	Norja	PROPN;NOM;SG
kuldankarvaane	kuldankarvaane	ADJ;ACC;SG
oksa	oksa	N;ACC;SG
arbuuze	arbuuze	N;NOM;SG
labido	labido	N;ACC;SG
kindas	kindas	N;ACC;SG
huogiš	huogiš	ADJ;ACC;SG
koufkuot	koufkuot	N;ACC;SG
kananpoigad	kananpoigad	N;NOM;PL
biibal	biibal	N;NOM;SG
keskuč	keskučas	N;IN+ESS;SG
lutti	lutti	N;ACC;SG
Barduoiniemi	Barduoiniemi	PROPN;ACC;SG
udareh	udareh	N;NOM;SG
očč	očč	N;NOM;SG
mielöu	mielöu	ADJ;NOM;SG
muuroi	muuroi	N;NOM;SG
kerä	kerä	N;NOM;SG
sügüz	sügüz	N;NOM;SG
sončar	sončar	N;ACC;SG
küünäl	küünäl	N;ACC;SG
maid	maid	N;NOM;SG
pojezd	pojezd	N;ACC;SG
gimnazii	gimnazii	N;ACC;SG
mägär	mägär	N;ACC;SG
hoikk	hoikk	ADJ;NOM;SG
nimipäive	nimipäiväd	N;NOM;PL
kolmašpäi	kolmašpäi	N;NOM;SG
piäčöi	piäčöi	N;NOM;SG
sobad	sobad	N;ACC;SG
kuoreh	kuoreh	N;ACC;SG
vedädä	vedän	V;IND;SG;1;POS;PRS
petle	petle	N;ACC;SG
bl’uod	bl’uod	N;ACC;SG
kurtke	kurtke	N;NOM;SG
vilu	vilu	N;NOM;SG
tuhk	tuhk	N;NOM;SG
nork	nork	N;NOM;SG
d’orši	d’orši	N;NOM;SG
aige	aigan	N;ACC;SG
siäri	siäri	N;NOM;SG
telaga	telaga	N;NOM;SG
taibaleh	taibaleh	N;NOM;SG
šurd’jak	šurd’jak	N;NOM;SG
rida	rida	N;ACC;SG
keruoi	keruoi	N;ACC;SG
tuhke	tuhke	N;ACC;SG
aho	aho	N;ACC;SG
lapsi	lapsi	N;ACC;SG
viršši	viršši	N;ACC;SG
taine	taine	N;NOM;SG
höuhenyt	höuhenyt	N;ACC;SG
suvaita	suvaičen	V;IND;SG;1;POS;PRS
rokke	rokke	N;ACC;SG
kuom	kuom	N;NOM;SG
tagaraivo	tagaraivo	N;ACC;SG
noid	noid	N;NOM;SG
puhas	puhas	ADJ;ACC;SG
kurikka	kurikka	N;NOM;SG
tuhka	tuhka	N;ACC;SG
makse	makse	N;ACC;SG
raštau	raštau	N;ACC;SG
neičükke	neičükke	N;ACC;SG
čupukke	čupukke	N;ACC;SG
duhu	duhu	N;ACC;SG
diädö	diädöd	N;PRT;SG
suurima	suurima	N;ACC;SG
selgärango	selgärango	N;NOM;SG
bies	bies	N;ACC;SG
küuk	küuk	N;ACC;SG
televizor	televizor	N;NOM;SG
Kažinpäive	Kažinpäiväd	PROPN;PRT;SG
student	student	N;NOM;SG
sormi	sormi	N;ACC;SG
pätne	pätne	N;ACC;SG
aidos	aidos	N;NOM;SG
suhkol	suhkol	N;NOM;SG
saum	saum	N;ACC;SG
biliette	biliette	N;ACC;SG
pyhärvelaine	pyhärvelaine	N;ACC;SG
tuske	tuske	N;ACC;SG
puik	puik	N;ACC;SG
kägüöi	kägüöi	N;ACC;SG
zirkkalo	zirkkalo	N;ACC;SG
ajada	ajat	V;IND;SG;2;POS;PRS
valuda	valuu	V;IND;SG;3;POS;PRS
matka	matka	N;NOM;SG
kiima	kiima	N;NOM;SG
s’urtukke	s’urtukke	N;ACC;SG
kongress	kongress	N;NOM;SG
suimu	suimu	N;ACC;SG
työ	työ	PRO;ACC;SG
olda	oliš	V;COND;SG;3;POS;PRS
peld	peld	N;ACC;SG
mogil	mogil	N;ACC;SG
čirpi	čirpi	N;NOM;SG
nuokke	nuokke	N;NOM;SG
četvert’	četvert’	N;NOM;SG
mozgu	mozgu	N;NOM;SG
mamoi	mamoi	N;NOM;SG
snuap	snuap	N;NOM;SG
varu	varu	N;ACC;SG
sinine	sinine	ADJ;ACC;SG
voi	voi	N;ACC;SG
päčči	päčilluo	N;APPRX;SG
sananik	sananik	N;NOM;SG
päged	päged	N;NOM;SG
virga	virga	N;ACC;SG
kylä	kylä	N;ACC;SG
vilk	vilk	N;NOM;SG
kobre	kobre	N;ACC;SG
ristituatto	ristituatto	N;NOM;SG
kopeik	kopeik	N;NOM;SG
toži	toži	N;NOM;SG
siga	siga	N;ACC;SG
käbrü	käbrü	N;NOM;SG
hirve	hirve	N;NOM;SG
kirjuttada	kirjutan	V;IND;SG;1;POS;PRS
dorši	dorši	N;NOM;SG
kerd	kerd	N;NOM;SG
n’aba	n’aba	N;NOM;SG
mužikk	mužikk	N;ACC;SG
emände	emände	N;NOM;SG
herneg	herneg	N;NOM;SG
opastund	opastund	N;ACC;SG
ahven	ahven	N;ACC;SG
hyö	heis	PRO;IN+ABL;SG
ruogo	ruogo	N;NOM;SG
perä	perä	N;NOM;SG
pahk	pahk	N;NOM;SG
ikränk	ikränk	N;NOM;SG
mereži	mereži	N;NOM;SG
myö	myö	PRO;NOM;SG
kydy	kydy	N;NOM;SG
luaskave	luaskave	ADJ;ACC;SG
leht	leht	N;NOM;SG
mäkinat	mäkinat	N;NOM;SG
uudima	uudima	N;NOM;SG
suobat	suobat	N;NOM;SG
käbü	käbü	N;NOM;SG
dvora	dvora	N;NOM;SG
kulda	kulda	N;ACC;SG
itkettäjö	itkettäjö	N;ACC;SG
taba	taba	N;ACC;SG
stauč	stauč	N;ACC;SG
kološšad	kološšad	N;ACC;SG
pieksädä	pieksän	V;IND;SG;1;POS;PRS
tožnarg	tožnargen	N;BYWAY;SG
kirikkö	kirikköh	N;IN+ALL;SG
sokke	sokke	N;NOM;SG
nägemiine	nägemiine	N;NOM;SG
šliäppe	šliäppe	N;NOM;SG
liga	liga	N;NOM;SG
atkau	atkau	N;NOM;SG
haud	haud	N;NOM;SG
laih	laih	ADJ;NOM;SG
kofej	kofej	N;NOM;SG
röččä	röččä	N;NOM;SG
katos	katos	N;NOM;SG
iškedä	išköy	V;IND;SG;1;POS;PRS
päivä	päivä	N;NOM;SG
pola	pola	N;NOM;SG
n’okke	n’okaz	N;IN+ESS;SG
d’uomoi	d’uomoi	N;NOM;SG
verai	verai	N;NOM;SG
tiähti	tiähti	N;NOM;SG
jarmankad	jarmankad	N;NOM;SG
tožar’g’	tožar’g’	N;ACC;SG
aiž	aiž	N;NOM;SG
hudr	hudr	ADJ;ACC;SG
muiged	muiged	ADJ;ACC;SG
kibedahiine	kibedahiine	ADJ;NOM;SG
kualelda	kualelen	V;IND;SG;1;POS;PRS
petkel’	petkel’	N;ACC;SG
hapaimaido	hapaimaido	N;ACC;SG
viizas	viizas	ADJ;NOM;SG
gluhuoi	gluhuoi	ADJ;ACC;SG
skančča	skančča	N;NOM;SG
tuačke	tuačke	N;NOM;SG
polvi	polvi	N;NOM;SG
pühäpäi	pühäpäi	N;NOM;SG
ait	ait	N;NOM;SG
kehno	kehno	ADJ;ACC;SG
märge	märge	ADJ;ACC;SG
Priäža	Priäža	PROPN;NOM;SG
gajag	gajag	N;NOM;SG
purdilo	purdilo	N;NOM;SG
čustvuida	čuvstvuin	V;IND;SG;1;POS;PRS
painada	painan	V;IND;SG;1;POS;PRS
mečče	mecis	N;IN+ABL;PL
kirjuttada	kirjuttau	V;IND;SG;3;POS;PRS
kidžu	kidžu	N;ACC;SG
ščipčad	ščipčad	N;ACC;SG
peldovaruoi	peldovaruoi	N;ACC;SG
valmiz	valmiz	ADJ;ACC;SG
tagimane	tagimane	ADJ;ACC;SG
pašporte	pašporte	N;ACC;SG
izr	izr	N;ACC;SG
aluste	aluste	N;ACC;SG
lähelline	lähelline	ADJ;ACC;SG
harmag	harmag	ADJ;NOM;SG
n’uokkida	n’uokin	V;IND;SG;1;POS;PRS
iškim	iškim	N;NOM;SG
endžimaižar’g	endžimaižar’g	N;NOM;SG
voivalline	voivalline	ADJ;ACC;SG
tajembaine	tajembaine	ADJ;NOM;SG
muloine	muloine	ADJ;NOM;SG
huaba	huaba	N;ACC;SG
kuikke	kuikke	N;ACC;SG
kirvesvarzi	kirvesvarzi	N;ACC;SG
trupk	trupk	N;ACC;SG
ruoste	ruoste	N;ACC;SG
käbryöossieni	käbryöossieni	N;ACC;SG
kindei	kindei	ADJ;ACC;SG
rängydä	rängyn	V;IND;SG;1;POS;PRS
särgi	särgi	N;ACC;SG
k’aludim	k’aludim	N;ACC;SG
leuga	leuga	N;ACC;SG
riibu	riibu	N;ACC;SG
külmä	külmä	ADJ;ACC;SG
sroičč	sroičč	N;NOM;SG
vuoži	vuoži	N;NOM;SG
koira	koira	N;NOM;SG
maksa	maksa	N;NOM;SG
parvi	parvi	N;NOM;SG
kartofei	kartofei	N;NOM;SG
ohjaksed	ohjaksed	N;NOM;SG
palttin	palttin	N;NOM;SG
naine	naine	N;NOM;SG
mehiläine	mehiläine	N;ACC;SG
opastui	opastui	N;NOM;SG
šild	šild	N;NOM;SG
stol’ari	stol’ari	N;NOM;SG
tuohus	tuohus	N;NOM;SG
babke	babke	N;ACC;SG
pučči	pučči	N;ACC;SG
sulge	sulge	N;ACC;SG
kass	kass	N;NOM;SG
halgelmas	halgelmas	N;ACC;SG
astuda	olnuiš astunu	V;PRF;COND;SG;3;POS;PST
šuapug	šuapug	N;ACC;SG
päi	päi	N;ACC;SG
astuda	ei astune	V;POT;SG;3;NEG;PRS
neče	neče	PRO;NOM;SG
moni	moned	PRO;NOM;PL
šleja	šleja	N;NOM;SG
funt	funt	N;ACC;SG
ykssilme	ykssilme	ADJ;NOM;SG
palgu	palgu	N;NOM;SG
čugu	čugu	N;ACC;SG
karassin	karassin	N;ACC;SG
hibie	hibie	N;ACC;SG
kuačk	kuačk	N;ACC;SG
čubuhiiri	čubuhiiri	N;NOM;SG
pakaine	pakaine	N;NOM;SG
täpin	täpin	N;NOM;SG
saraffan	saraffan	N;ACC;SG
emändim	emändim	N;ACC;SG
uaskonda	uaskonda	N;ACC;SG
veikuoi	veikuoi	N;NOM;SG
muru	muru	N;NOM;SG
kuar	kuar	N;ACC;SG
armaz	armhad	ADJ;NOM;PL
stradaita	stradaičen	V;IND;SG;1;POS;PRS
ägä	ägä	N;NOM;SG
plita	plita	N;NOM;SG
diplom	diplom	N;NOM;SG
neižne	neižne	N;ACC;SG
koless	koless	N;ACC;SG
saksalaine	saksalaine	N;NOM;SG
sekretar’	sekretar’	N;NOM;SG
mieš	mieš	N;ACC;SG
tukke	tukke	N;NOM;SG
soimi	soimi	N;ACC;SG
kohtu	kohtu	N;NOM;SG
vald	vald	N;NOM;SG
Kujärv	Kudärvehe	PROPN;IN+ALL;SG
kytkedä	kytken	V;IND;SG;1;POS;PRS
mömmettada	mömmetan	V;IND;SG;1;POS;PRS
usk	usk	N;NOM;SG
palo	palo	N;NOM;SG
ombelmas	ombelmaksed	N;NOM;PL
maho	maho	ADJ;ACC;SG
verge	verge	N;NOM;SG
sauvva	sauvva	N;ACC;SG
mua	mua	N;ACC;SG
uveh	uveh	N;ACC;SG
perti	perti	N;ACC;SG
šelguoine	šelguoine	N;ACC;SG
präškä	präškä	N;NOM;SG
käbäläine	käbäläine	N;NOM;SG
čihkoi	čihkoi	N;NOM;SG
merkki	merkki	N;NOM;SG
uušte	uušte	N;NOM;SG
paid	paid	N;NOM;SG
däiččü	däiččü	N;NOM;SG
muokke	muokke	N;NOM;SG
mečče	mecad	N;NOM;PL
teatr	teatr	N;ACC;SG
varza	varza	N;ACC;SG
sisär	sisär	N;ACC;SG
leivät	leivät	N;ACC;SG
vandeh	vandeh	N;ACC;SG
kird’	kird’	N;ACC;SG
kirikkö	kirikkö	N;ACC;SG
jaščikke	jaščikke	N;ACC;SG
hyvä	hyvih	ADJ;IN+ALL;PL
molida	molin	V;IND;SG;1;POS;PRS
tämä	tämä	PRO;ACC;SG
taluo	taluo	N;NOM;SG
ut’užindanpert’	ut’užindanpert’	N;NOM;SG
ambuda	ambun	V;IND;SG;1;POS;PRS
ruod	ruod	N;ACC;SG
kalu	kalu	N;ACC;SG
kätküd	kätküd	N;ACC;SG
riih	riih	N;NOM;SG
tougo	tougo	N;NOM;SG
vyö	vyö	N;NOM;SG
numer	numer	N;ACC;SG
pruabuab	pruabuab	N;NOM;SG
molembad	molembad	PRO;ACC;SG
mureta	murendan	V;IND;SG;1;POS;PRS
dorog	dorogad	N;NOM;PL
šide	šide	N;NOM;SG
rinde	rinde	N;ACC;SG
rugo	rugo	N;ACC;SG
kaskes	kaskes	N;ACC;SG
stanke	stanke	N;NOM;SG
konztahto	konztahto	PRO;NOM;SG
niem	niem	N;NOM;SG
lippi	lippi	N;ACC;SG
ünnälliine	ünnälliine	N;ACC;SG
gimnastiekk	gimnastiekk	N;ACC;SG
paik	paik	N;ACC;SG
piipp	piipp	N;ACC;SG
sanoda	sanoi	V;IPFV;IND;SG;3;POS;PST
kabu	kabu	N;ACC;SG
lätäkkö	lätäkkö	N;NOM;SG
kaiduz	kaiduz	N;ACC;SG
paha	paha	N;ACC;SG
sup	sup	N;ACC;SG
krott	krott	N;NOM;SG
eziine	eziine	ADJ;NOM;SG
voitta	voidan	V;IND;SG;1;POS;PRS
höuhen’	höuhen’	N;NOM;SG
sinini	sinini	ADJ;NOM;SG
kohte	kohte	N;NOM;SG
lahko	lahko	N;NOM;SG
zahari	zahari	N;ACC;SG
katuhke	katuhke	N;NOM;SG
tallt	tallt	N;NOM;SG
ruble	ruble	N;NOM;SG
tabakke	tabakke	N;NOM;SG
miehad	miehad	N;ACC;SG
tuohi	tuohi	N;NOM;SG
riehtilä	riehtilä	N;NOM;SG
argi	argi	N;NOM;SG
šur’d’akke	šur’d’akke	N;ACC;SG
podr’ušnikke	podr’ušnikke	N;NOM;SG
kosuoi	kosuoi	N;NOM;SG
edine	edine	ADJ;NOM;SG
päivännouzm	päivännouzm	N;NOM;SG
lapsenkaččuoi	lapsenkaččuoi	N;NOM;SG
hall	hall	N;NOM;SG
kättüt	kättüt	N;NOM;SG
huomessyöm	huomessyöm	N;NOM;SG
saivar	saivar	N;NOM;SG
puikko	puikko	N;ACC;SG
ajand	ajand	N;ACC;SG
koppalo	koppalo	N;NOM;SG
rote	rote	N;NOM;SG
ruahtovezi	ruahtovezi	N;ACC;SG
pöürü	pöürü	N;ACC;SG
sagarm	sagarm	N;NOM;SG
kylbedä	kylben	V;IND;SG;1;POS;PRS
kühküine	kühküine	N;NOM;SG
Barduoiniemi	Barduoiniemi	PROPN;NOM;SG
sülü	sülü	N;NOM;SG
regi	regi	N;NOM;SG
künnüs	künnüs	N;NOM;SG
lähtäm	lähtäm	N;NOM;SG
čekad	čekad	N;ACC;SG
kormeni	kormeni	N;ACC;SG
silittädä	silitän	V;IND;SG;1;POS;PRS
varba	varba	N;NOM;SG
loukku	loukku	N;NOM;SG
palveilii	palveilii	N;NOM;SG
segatavarad	segatavarad	N;NOM;SG
helve	helve	N;NOM;SG
mähände	mähände	N;ACC;SG
jad	jad	N;ACC;SG
küdü	küdü	N;ACC;SG
pirua	pirua	N;NOM;SG
selge	selge	N;NOM;SG
künä	künä	N;NOM;SG
ruata	ruadan	V;IND;SG;1;POS;PRS
päive	päive	N;ACC;SG
värtinäine	värtinäine	N;ACC;SG
vuakse	vuakse	N;NOM;SG
rahkiž	rahkiž	N;NOM;SG
pohja	pohja	N;NOM;SG
raudat	raudat	N;NOM;SG
mökiine	mökiine	N;NOM;SG
käži	käži	N;NOM;SG
kuldaine	kuldaižed	ADJ;NOM;PL
šivu	šivu	N;NOM;SG
maim	maim	N;NOM;SG
mekko	mekko	N;NOM;SG
ohjakset	ohjakset	N;ACC;SG
pulluone	pulluone	N;NOM;SG
selguine	selguine	N;NOM;SG
vidin	vidin	N;NOM;SG
zuakkon	zuakkon	N;ACC;SG
parte	parte	N;ACC;SG
peldovaroi	peldovaroi	N;ACC;SG
kal’žut	kal’žut	N;ACC;SG
viero	viero	N;ACC;SG
nel’l’kke	nel’l’kke	N;ACC;SG
d’uoksemiine	d’uoksemiine	N;ACC;SG
nahka	nahka	N;NOM;SG
artug	artug	N;NOM;SG
prawda	prawda	N;ACC;SG
nahke	nahke	N;ACC;SG
ahaz	ahaz	ADJ;NOM;SG
vunukka	vunukka	N;ACC;SG
lieččida	liečči	V;IPFV;IND;SG;3;POS;PST
uskomiine	uskomiine	N;ACC;SG
huttu	huttu	N;ACC;SG
keitandpert’	keitandpert’	N;ACC;SG
kevät	kevät	N;NOM;SG
orle	orle	N;NOM;SG
sestruoi	sestruoi	N;NOM;SG
mečče	mečäs	N;IN+ESS;SG
keskmaane	keskmaane	ADJ;NOM;SG
azbukke	azbukke	N;NOM;SG
vederist	vederist	N;NOM;SG
modnuoi	modnuoi	ADJ;NOM;SG
tuagei	tuagei	ADJ;ACC;SG
taine	taine	N;ACC;SG
se	sen	PRO;GEN;SG
olda	et olnuiš	V;IPFV;COND;SG;2;NEG;PST
bohatte	bohatte	ADJ;ACC;SG
kuorittada	kuoritan	V;IND;SG;1;POS;PRS
miär’	miär’	N;NOM;SG
piirag	piirag	N;ACC;SG
nedäl’i	nedäl’i	N;ACC;SG
kuhn’e	kuhn’e	N;ACC;SG
pügäl	pügäl	N;NOM;SG
armotoin	armotoin	N;NOM;SG
korvatuoi	korvatuoi	ADJ;ACC;SG
dälgimbäne	dälgimbäne	ADJ;ACC;SG
opastund	opastundad	N;PRT;SG
kummakaz	kummakaz	ADJ;ACC;SG
nyble	nyble	N;NOM;SG
koumanžpäiv	koumanžpäiv	N;NOM;SG
riepuoi	riepuoi	N;NOM;SG
zirkal	zirkal	N;NOM;SG
härkim	härkim	N;ACC;SG
pohd’aane	pohd’aane	N;ACC;SG
strannike	strannike	N;ACC;SG
stola	stolaha	N;IN+ALL;SG
vepsäläzed	vepsäläzed	N;ACC;SG
kulaktorai	kulaktorai	N;NOM;SG
vajehtys	vajehtys	N;NOM;SG
ripšu	ripšu	N;ACC;SG
molembad	molembad	PRO;NOM;SG
bapk	bapk	N;NOM;SG
vattagine	vattagine	ADJ;ACC;SG
onzi	onzi	N;ACC;SG
mal’arida	mal’arin	V;IND;SG;1;POS;PRS
vihk	vihk	N;ACC;SG
bohatt	bohatt	ADJ;NOM;SG
vahalauk	vahalauk	N;NOM;SG
korva	korva	N;NOM;SG
osle	osle	N;NOM;SG
matkalaine	matkalaine	N;NOM;SG
raht	raht	N;ACC;SG
kavazluud	kavazluud	N;NOM;SG
paginsanakniig	paginsanakniig	N;NOM;SG
armotoine	armotoine	N;NOM;SG
viizaš	viizaš	ADJ;ACC;SG
salmago	salmago	N;ACC;SG
kuačku	kuačku	N;ACC;SG
höuhen	höuhen	N;ACC;SG
adra	adra	N;ACC;SG
rinnus	rinnus	N;ACC;SG
sananik	sananik	N;ACC;SG
päged	päged	N;ACC;SG
perže	perže	N;ACC;SG
biede	biede	N;ACC;SG
kuožali	kuožali	N;NOM;SG
käbrü	käbrü	N;ACC;SG
hirve	hirve	N;ACC;SG
počiine	počiine	N;NOM;SG
vaste	vaste	N;NOM;SG
laudaine	laudaine	N;NOM;SG
aldo	aldo	N;NOM;SG
stola	stola	N;NOM;SG
kul’a	kul’a	N;NOM;SG
treske	treske	N;ACC;SG
kudai	kudai	PRO;NOM;SG
täüze	täüze	N;NOM;SG
leibä	leibä	N;NOM;SG
üks’tošt	üks’tošt	N;NOM;SG
ušte	ušte	N;ACC;SG
sammal	sammal	N;ACC;SG
kangasstavinad	kangasstavinad	N;ACC;SG
petkeli	petkeli	N;ACC;SG
painoatletik	painoatletik	N;ACC;SG
breičind	breičind	N;NOM;SG
ruode	ruode	N;NOM;SG
toineargi	toineargi	N;NOM;SG
päičet	päičet	N;NOM;SG
abei	abei	N;ACC;SG
veikki	veikki	N;NOM;SG
lang	lang	N;ACC;SG
myönde	myönde	N;ACC;SG
luu	luu	N;ACC;SG
guikke	guikke	N;NOM;SG
ripsu	ripsu	N;NOM;SG
kuničč	kuničč	N;NOM;SG
armas	armas	ADJ;ACC;SG
oboz	oboz	N;ACC;SG
harakanhein	harakanhein	N;ACC;SG
kuudain	kuudain	N;ACC;SG
obraz	obraz	N;NOM;SG
pullone	pullone	N;NOM;SG
lindžuoi	lindžuoi	N;NOM;SG
mäkinat	mäkinat	N;ACC;SG
tötküt	tötküt	N;NOM;SG
pletti	pletti	N;NOM;SG
uudima	uudima	N;ACC;SG
aloveh	aloveh	N;NOM;SG
valda	valda	N;ACC;SG
kuničče	kuničče	N;NOM;SG
svuadibo	svuadibo	N;NOM;SG
nuoraine	nuoraine	N;NOM;SG
mielehine	mielehine	ADJ;ACC;SG
üskä	üskä	N;ACC;SG
künäbrüs	künäbrüs	N;ACC;SG
siened	siened	N;ACC;SG
kanabr	kanabr	N;NOM;SG
suu	suu	N;NOM;SG
kuha	kuha	N;NOM;SG
pehmed	pehmed	ADJ;ACC;SG
haud	haud	N;ACC;SG
atkau	atkau	N;ACC;SG
nägemiine	nägemiine	N;ACC;SG
karžina	karžina	N;ACC;SG
šliäppe	šliäppe	N;ACC;SG
izre	izre	N;ACC;SG
räkke	räkke	N;ACC;SG
särištä	särižen	V;IND;SG;1;POS;PRS
sulakuu	sulakuu	N;ACC;SG
kengätombelii	kengätombelii	N;ACC;SG
vaskine	vaskine	N;ACC;SG
katos	katos	N;ACC;SG
röčče	röčče	N;NOM;SG
selgerango	selgerango	N;ACC;SG
mina	mina	PRO;ACC;SG
d’agada	d’agettii	V;IPFV;IND;PL;3;POS;PST;REFL
tihie	tihie	ADJ;ACC;SG
okse	okse	N;ACC;SG
rikkovo	rikkovo	N;ACC;SG
magaduspert’	magaduspert’	N;ACC;SG
ubar	ubar	N;NOM;SG
kuakištada	kuakištan	V;IND;SG;1;POS;PRS
d’uoksii	d’uoksii	N;NOM;SG
rundug	rundug	N;ACC;SG
mečče	mecinke	N;COM;PL
linna	linna	N;ACC;SG
kugal	kugal	PRO;NOM;SG
d’yrke	d’yrke	ADJ;ACC;SG
madala	madala	ADJ;ACC;SG
piä	piä	ADJ;NOM;SG
kiež	kiež	N;NOM;SG
sudje	sudje	N;NOM;SG
pala	palad	N;NOM;PL
käzi	käzi	N;NOM;SG
dorog	dorog	N;ACC;SG
roskaine	roskaine	N;ACC;SG
ast’uoid	ast’uoid	N;ACC;SG
nimenpanemiine	nimenpanemiine	N;ACC;SG
sulaim	sulaim	N;ACC;SG
kirvez	kirvez	N;ACC;SG
huršti	huršti	N;ACC;SG
unkarilaine	unkarilaine	N;ACC;SG
gor’uita	gor’uičen	V;IND;SG;1;POS;PRS
d’ärvi	d’ärvi	N;NOM;SG
haugod	haugod	N;NOM;SG
ven’alazet	ven’alazet	N;ACC;SG
kuav	kuav	N;ACC;SG
ramke	ramke	N;NOM;SG
räkki	räkki	N;NOM;SG
Priäža	Priäža	PROPN;ACC;SG
liide	liide	N;NOM;SG
šäng	šäng	N;NOM;SG
Riga	Riga	PROPN;ACC;SG
Ven’a	Ven’a	PROPN;NOM;SG
viha	viha	N;NOM;SG
derein’	derein’	N;ACC;SG
šurd’akko	šurd’akko	N;NOM;SG
poštumark	poštumark	N;NOM;SG
kazne	kazne	N;NOM;SG
omad	omas	N;IN+ESS;SG
čumučiučuoi	čumučiučuoi	N;NOM;SG
päivystäi	päivystäi	N;NOM;SG
varuoi	varuoi	N;NOM;SG
priha	priha	N;ACC;SG
hurme	hurme	N;NOM;SG
hanh	hanh	N;NOM;SG
n’akut	n’akut	N;ACC;SG
halgedelta	halgeldelen	V;IND;SG;1;POS;PRS
kualada	kualan	V;IND;SG;1;POS;PRS
suarne	suarne	N;NOM;SG
rizu	rizu	N;NOM;SG
valde	valde	N;NOM;SG
šolgu	šolgu	N;ACC;SG
mezikämmen	mezikämmen	N;ACC;SG
purdilo	purdilo	N;ACC;SG
leppä	leppä	N;NOM;SG
kukkaro	kukkaro	N;NOM;SG
ristikanz	ristikanz	N;NOM;SG
suabra	suabra	N;NOM;SG
enžimašar’g	enžimašar’g	N;NOM;SG
laid	laid	N;ACC;SG
kiim	kiim	N;NOM;SG
sälgy	sälgy	N;NOM;SG
peldo	peldo	N;NOM;SG
ikkuna	ikkuna	N;NOM;SG
villaine	villaine	ADJ;NOM;SG
askel	askel	N;NOM;SG
licei	licei	N;ACC;SG
astuda	lienet astunu	V;PRF;POT;SG;2;POS;PRS
vunuk	vunuk	N;NOM;SG
ezmažarg	ezmažarg	N;NOM;SG
bembeli	bembeli	N;NOM;SG
teatr	teatras	N;IN+ESS;SG
čuhuoi	čuhuoi	N;NOM;SG
kokke	kokke	N;ACC;SG
nuott	nuottil’	N;AT+ESS;PL
zvone	zvone	N;NOM;SG
lahga	lahga	N;NOM;SG
velg	velg	N;ACC;SG
oja	oja	N;ACC;SG
riid	riid	N;NOM;SG
tožinar’g	tožinar’g	N;ACC;SG
maid	maid	N;ACC;SG
kevaž	kevaž	N;ACC;SG
vakaine	vakaine	N;NOM;SG
siä	siä	N;NOM;SG
ižände	ižände	N;NOM;SG
kriške	kriške	N;NOM;SG
viesat	viesat	N;NOM;PL
kierd	kierd	N;NOM;SG
kirppu	kirppu	N;ACC;SG
n’auguda	n’augottud	V.PTCP;PST;PASS
mečče	mečil	N;AT+ESS;PL
vel’l’	vel’l’este	N;PRT;SG
harakk	harakk	N;ACC;SG
kiškoi	kiškoi	N;ACC;SG
vilu	vilu	N;ACC;SG
kurtke	kurtke	N;ACC;SG
ar’g	ar’g	N;ACC;SG
mi	mi	PRO;NOM;SG
kiägä	kiägä	N;NOM;SG
kudr’avoi	kudr’avoi	ADJ;NOM;SG
sinini	sinini	ADJ;ACC;SG
kaži	kažid	N;PRT;SG
naine	naine	N;ACC;SG
ohjaksed	ohjaksed	N;ACC;SG
palttin	palttin	N;ACC;SG
artteli	artteli	N;ACC;SG
kiäge	kiäge	N;ACC;SG
suabranpuu	suabranpuu	N;ACC;SG
čihv	čihv	N;ACC;SG
kulu	kulu	ADJ;ACC;SG
astuda	emme astuiš	V;COND;PL;1;NEG;PRS
kebie	kebie	ADJ;NOM;SG
koukku	koukku	N;ACC;SG
luzikka	luzikka	N;ACC;SG
huabe	huabe	N;ACC;SG
Vaugedven’a	Vaugedven’a	PROPN;ACC;SG
voine	voine	N;ACC;SG
veraa	veraa	N;NOM;SG
died	died	N;NOM;SG
iče	ičes	PRO;IN+ABL;SG
taza	taza	ADJ;NOM;SG
kynz’	kynz’	N;NOM;SG
čupp	čupp	N;NOM;SG
paarussu	paarussu	N;NOM;SG
randu	randu	N;NOM;SG
huobavus	huobavus	N;NOM;SG
sarga	sarga	N;NOM;SG
podval	podval	N;ACC;SG
marke	marke	N;ACC;SG
polotne	polotne	N;ACC;SG
grubuoi	grubuoi	ADJ;ACC;SG
piivo	piivo	N;NOM;SG
abai	abai	N;NOM;SG
sulg	sulg	N;ACC;SG
kalme	kalme	N;ACC;SG
kiäbräine	kiäbräine	N;ACC;SG
varuo	varuo	N;NOM;SG
sekretar’	sekretar’	N;ACC;SG
päiv	päiväd	N;PRT;SG
čüöttö	čüöttö	N;NOM;SG
linduoi	linduoi	N;NOM;SG
huonnus	huonnus	N;NOM;SG
meri	meri	N;NOM;SG
elokuu	elokuu	N;NOM;SG
pahka	pahka	N;NOM;SG
tihut	tihut	N;NOM;SG
nimennökke	nimennökke	N;NOM;SG
lind	lind	N;NOM;SG
razv	razv	N;ACC;SG
läzijä	läzijä	ADJ;NOM;SG
harva	harva	ADJ;ACC;SG
laške	laške	ADJ;NOM;SG
lašk	lašk	ADJ;NOM;SG
palo	palo	N;ACC;SG
orahankarvaine	orahankarvaine	ADJ;NOM;SG
kapotte	kapotte	N;NOM;SG
počinpoiga	počinpoiga	N;NOM;SG
tulovišš	tulovišš	N;NOM;SG
pulčukka	pulčukka	N;NOM;SG
emälammas	emälammas	N;NOM;SG
huogam	huogam	N;NOM;SG
kiittädä	kiitän	V;IND;SG;1;POS;PRS
ložme	ložme	N;ACC;SG
astavu	astavu	N;ACC;SG
atkal	atkal	N;ACC;SG
nosta	nouzen	V;IND;SG;1;POS;PRS
keväz	keväz	N;NOM;SG
skančče	skančče	N;ACC;SG
orahat	orahat	N;ACC;SG
labid	labid	N;ACC;SG
uuzi	uuzi	ADJ;NOM;SG
pohkie	pohkie	N;NOM;SG
kühläs	kühläs	N;ACC;SG
tal’v	tal’v	N;ACC;SG
kirjaopastu	kirjaopastu	N;ACC;SG
muštada	muštan	V;IND;SG;1;POS;PRS
puras	puras	N;NOM;SG
paikka	paikka	N;ACC;SG
diäslit	diäslit	N;ACC;SG
bohattuda	bohatun	V;IND;SG;1;POS;PRS
zavodida	zavodittih	V;IPFV;IND;PL;3;POS;PST;REFL
nel’lanpäiv	nel’lanpäiv	N;ACC;SG
pielus	pielus	N;NOM;SG
huatte	huatte	N;ACC;SG
talkun	talkun	N;ACC;SG
dvora	dvora	N;ACC;SG
käbü	käbü	N;ACC;SG
sivu	sivu	N;NOM;SG
keskus	keskus	N;NOM;SG
tiinu	tiinu	N;NOM;SG
lämmä	lämmä	ADJ;ACC;SG
vakk	vakk	N;NOM;SG
ris	ris	N;NOM;SG
stokan	stokan	N;NOM;SG
šide	šide	N;ACC;SG
kiere	kiere	N;NOM;SG
usad	usad	N;NOM;PL
suola	suola	N;ACC;SG
liivaz	liivaz	N;NOM;SG
nimi	nimi	N;NOM;SG
vyö	vyö	N;ACC;SG
tougo	tougo	N;ACC;SG
riibaimal	riibaimal	N;ACC;SG
riih	riih	N;ACC;SG
valmiš	valmiš	ADJ;NOM;SG
virst	virst	N;ACC;SG
elaige	elaigah	N;IN+ALL;SG
enzimäneargi	enzimäneargi	N;NOM;SG
lätäkkö	lätäkkö	N;ACC;SG
licei	licejad	N;PRT;SG
ruškičča	ruškičča	N;ACC;SG
luistelupeld	luistelupeld	N;NOM;SG
murdo	murdo	N;NOM;SG
luja	luja	ADJ;ACC;SG
piiluine	piiluine	N;ACC;SG
gajakk	gajakk	N;ACC;SG
varoi	varoi	N;NOM;SG
kirpičče	kirpičče	N;NOM;SG
melata	meladan	V;IND;SG;1;POS;PRS
kover	kover	ADJ;ACC;SG
nuužnik	nuužnik	N;ACC;SG
puali	puali	N;NOM;SG
kulakko	kulakko	N;NOM;SG
vuare	vuare	N;ACC;SG
vieras	vieras	N;ACC;SG
kyndys	kyndys	N;ACC;SG
urokk	urokk	N;NOM;SG
zavalin	zavalin	N;NOM;SG
röčč	röčč	N;ACC;SG
kezakodi	kezakodi	N;ACC;SG
hyvä	hyvän	ADJ;ACC;SG
d’uged	d’uged	ADJ;NOM;SG
riäpüöi	riäpüöi	N;NOM;SG
pieluspiäline	pieluspiäline	N;NOM;SG
ukrainalaine	ukrainalaine	N;NOM;SG
kieletöi	kieletöi	ADJ;ACC;SG
izvesti	izvesti	N;ACC;SG
hukke	hukke	N;ACC;SG
kassa	kassa	N;ACC;SG
pihka	pihka	N;ACC;SG
turbe	turbe	N;ACC;SG
okl’uččim	okl’uččim	N;NOM;SG
suksi	suksi	N;ACC;SG
kanda	kanda	N;ACC;SG
luistelu	luistelu	N;ACC;SG
rokka	rokka	N;ACC;SG
kirjutin	kirjutin	N;ACC;SG
huonduz	huonduksel	N;AT+ESS;SG
hukka	hukka	N;ACC;SG
keskuč	keskuč	N;ACC;SG
kivez	kivez	N;ACC;SG
aitte	aitte	N;NOM;SG
saivar	saivar	N;ACC;SG
ruohk	ruohk	ADJ;ACC;SG
alasti	alasti	ADJ;ACC;SG
tovestuz	tovestust	N;PRT;SG
laih	laih	ADJ;ACC;SG
sorminahka	sorminahka	N;NOM;SG
den’gat	den’gat	N;NOM;SG
bokko	bokko	N;NOM;SG
n’auguda	ei n’augunuh	V;IPFV;IND;SG;3;NEG;PST
üöleloi	üöleloi	N;NOM;SG
laska	laska	N;NOM;SG
časoune	časounah	N;IN+ALL;SG
haju	haju	N;NOM;SG
koppalo	koppalo	N;ACC;SG
kopeikk	kopeikk	N;ACC;SG
paltina	paltina	N;ACC;SG
pyörälajai	pyörälajai	N;NOM;SG
ualdo	ualdo	N;NOM;SG
rahmannoi	rahmannoi	ADJ;ACC;SG
sualine	sualine	N;NOM;SG
hämähäkk	hämähäkk	N;ACC;SG
orazkuu	orazkuu	N;ACC;SG
ubeh	ubeh	N;ACC;SG
vero	vero	N;NOM;SG
rihme	rihme	N;NOM;SG
niemukke	niemukke	N;NOM;SG
nimipäive	nimipäive	N;NOM;SG
lastušk	lastušk	N;ACC;SG
hambahaine	hambahaine	N;ACC;SG
raudat	raudat	N;ACC;SG
šivu	šivu	N;ACC;SG
pohja	pohja	N;ACC;SG
tuagei	tuagei	ADJ;NOM;SG
ad’vo	ad’vo	N;NOM;SG
hebočče	hebočče	N;NOM;SG
tili	tili	N;NOM;SG
ozre	ozre	N;NOM;SG
razvaine	razvaine	ADJ;ACC;SG
mülü	mülü	ADJ;ACC;SG
polovikka	polovikka	N;NOM;SG
parvi	parvi	N;ACC;SG
üöliva	üöliva	N;ACC;SG
kartofei	kartofei	N;ACC;SG
keskškola	keskškolan	N;ACC;SG
mänettädä	mänetan	V;IND;SG;1;POS;PRS
ur’adnikke	ur’adnikke	N;NOM;SG
t’otka	t’otka	N;NOM;SG
nasmorka	nasmorka	N;NOM;SG
kofte	kofte	N;ACC;SG
kibos	kibos	N;NOM;SG
sroičča	sroičča	N;NOM;SG
hüübii	hüübii	N;ACC;SG
merkičus	merkičus	N;ACC;SG
selgüs	selgüs	N;NOM;SG
svuad’b	svuad’b	N;NOM;SG
zadornuoi	zadornuoi	ADJ;NOM;SG
artug	artug	N;ACC;SG
nahka	nahka	N;ACC;SG
rahka	rahka	N;ACC;SG
aktivine	aktivine	ADJ;ACC;SG
trezvuoi	trezvuoi	ADJ;ACC;SG
vävy	vävy	N;NOM;SG
murreh	murreh	N;ACC;SG
tukkad	tukkad	N;ACC;SG
kävelemiine	kävelemiine	N;ACC;SG
čihko	čihko	N;ACC;SG
luude	luude	N;ACC;SG
zor’a	zor’a	N;ACC;SG
madala	madala	ADJ;NOM;SG
kuurnis	kuurnis	ADJ;ACC;SG
nuaglane	nuaglane	N;NOM;SG
mečče	meččidh	N;IN+ALL;PL
giir’e	giir’e	N;ACC;SG
moločče	moločče	N;ACC;SG
torppe	torppe	N;ACC;SG
zamaske	zamaske	N;NOM;SG
kivi	kivi	N;NOM;SG
projekt	projekt	N;NOM;SG
surme	surme	N;NOM;SG
zuuhari	zuuhari	N;NOM;SG
koumanžpäiv	koumanžpäiv	N;ACC;SG
kartofeu	kartofeu	N;ACC;SG
riepuoi	riepuoi	N;ACC;SG
nyble	nyble	N;ACC;SG
brihačče	brihačče	N;ACC;SG
astuda	astunu	V.PTCP;PRS;PASS
kuhm	kuhm	N;ACC;SG
azrag	azrag	N;ACC;SG
guikk	guikk	N;ACC;SG
hiili	hiili	N;NOM;SG
niitt	niitt	N;NOM;SG
loma	loma	N;NOM;SG
vägöü	vägöü	ADJ;NOM;SG
muštada	en mušta	V;IND;SG;1;NEG;PRS
sizar	sizar	N;ACC;SG
paharubi	paharubi	N;ACC;SG
luasičču	luasičču	N;ACC;SG
atkala	atkala	N;ACC;SG
kärze	kärze	N;ACC;SG
fonar’i	fonar’i	N;ACC;SG
rihma	rihma	N;ACC;SG
razve	razve	N;ACC;SG
kohtu	kohtu	N;ACC;SG
karva	karva	N;NOM;SG
vald	vald	N;ACC;SG
eläu	eläu	ADJ;NOM;SG
usk	usk	N;ACC;SG
kodi	kodiš	N;IN+ESS;SG
astuda	ette ole astunu	V;PRF;IND;PL;2;NEG;PST
armotoine	armotoine	N;ACC;SG
paginsanakniig	paginsanakniig	N;ACC;SG
šüvä	šüvä	ADJ;NOM;SG
tazavald	tazavald	N;NOM;SG
aige	aigad	N;PRT;SG
ajada	ajan	V;IND;SG;1;POS;PRS
labie	labie	N;NOM;SG
sualiž	sualiž	N;NOM;SG
suurus	suurus	N;NOM;SG
robilo	robilo	N;ACC;SG
anop	anop	N;ACC;SG
takk	takk	N;ACC;SG
bubarko	bubarko	N;NOM;SG
kannikko	kannikko	N;NOM;SG
vidi	vidi	N;ACC;SG
pihlaja	pihlaja	N;ACC;SG
palk	palk	N;NOM;SG
urbe	urbe	N;NOM;SG
čorta	čorta	N;ACC;SG
randaine	randaine	N;ACC;SG
ezmažar’g’	ezmažar’g’	N;ACC;SG
rotta	rotta	N;ACC;SG
sambuttada	sambutan	V;IND;SG;1;POS;PRS
ruatta	ruadan	V;IND;SG;1;POS;PRS
muatkuu	muatkuu	N;NOM;SG
roštava	roštava	N;NOM;SG
paras	paras	ADJ;NOM;SG
kulme	kulme	N;ACC;SG
karjalaižed	karjalaižed	N;ACC;SG
kolmašpäiv	kolmašpäiv	N;NOM;SG
uni	uni	N;NOM;SG
pullone	pullone	N;ACC;SG
pletti	pletti	N;ACC;SG
aloveh	aloveh	N;ACC;SG
tötküt	tötküt	N;ACC;SG
levo	levo	N;NOM;SG
droždi	droždi	N;NOM;SG
azrain	azrain	N;ACC;SG
kondie	kondie	N;NOM;SG
suomelaine	suomelaine	N;NOM;SG
ripsu	ripsu	N;ACC;SG
guikke	guikke	N;ACC;SG
kuničč	kuničč	N;ACC;SG
pučiine	pučiine	N;NOM;SG
hubaine	hubaine	ADJ;ACC;SG
riida	riida	N;NOM;SG
nuolta	nuolen	V;IND;SG;1;POS;PRS
sugu	sugu	N;NOM;SG
kudr’avoi	kudr’avoi	ADJ;ACC;SG
kuha	kuha	N;ACC;SG
suu	suu	N;ACC;SG
valada	valan	V;IND;SG;1;POS;PRS
verkkomiäččykižai	verkkomiäččykižai	N;NOM;SG
laute	laute	N;ACC;SG
hašk	hašk	N;ACC;SG
kuokka	kuokka	N;ACC;SG
muurahaine	muurahaine	N;NOM;SG
tahas	tahas	N;NOM;SG
tazaine	tazaine	ADJ;NOM;SG
koilline	koilline	N;NOM;SG
notket	notket	ADJ;NOM;SG
bir’b	bir’b	N;ACC;SG
brosse	brosse	N;NOM;SG
pinde	pinde	N;NOM;SG
urakka	urakka	N;ACC;SG
mannittida	mannitin	V;IND;SG;1;POS;PRS
höuhen’	höuhen’	N;ACC;SG
ilves	ilves	N;NOM;SG
mečče	mečälly	N;APPRX;SG
toisargi	toisargi	N;ACC;SG
palava	palava	ADJ;NOM;SG
alašti	alašti	ADJ;ACC;SG
vezihiiri	vezihiiri	N;ACC;SG
lehtes	lehtes	N;ACC;SG
spora	spora	N;ACC;SG
barbik	barbik	N;ACC;SG
piäčküöi	piäčküöi	N;ACC;SG
kurs	kurs	N;NOM;PL
mändü	mändü	N;ACC;SG
äges	äges	N;ACC;SG
tieduoinikk	tieduoinikk	N;ACC;SG
piätinčče	piätinčče	N;NOM;SG
čaivuoi	čaivuoi	N;ACC;SG
huahlat	huahlat	N;NOM;SG
laida	laida	N;NOM;SG
liäv	liäv	N;NOM;SG
Ukraina	Ukraina	PROPN;NOM;SG
ramb	ramb	ADJ;ACC;SG
haugod	haugod	N;ACC;SG
šurd’akko	šurd’akko	N;ACC;SG
poštumark	poštumark	N;ACC;SG
kazne	kazne	N;ACC;SG
leveiočču	leveiočču	N;ACC;SG
varuoi	varuoi	N;ACC;SG
päivystäi	päivystäi	N;ACC;SG
sagarm	sagarm	N;ACC;SG
druuge	druuge	N;NOM;SG
hoidai	hoidai	N;NOM;SG
suališ	suališ	N;NOM;SG
pualikk	pualikk	N;NOM;SG
mel’ničče	mel’ničče	N;NOM;SG
rizu	rizu	N;ACC;SG
valde	valde	N;ACC;SG
ježa	ježa	N;NOM;SG
päiväine	päiväine	N;ACC;SG
uho	uho	N;NOM;SG
lineike	lineike	N;NOM;SG
treščotke	treščotke	N;ACC;SG
hummar	hummar	N;ACC;SG
ilo	ilo	N;ACC;SG
d’algaččet	d’algaččet	N;NOM;SG
labaz	labaz	N;NOM;SG
maido	maido	N;NOM;SG
kalaine	kalaine	N;NOM;SG
tyhje	tyhje	N;NOM;SG
sumu	sumu	N;ACC;SG
porohe	porohe	N;NOM;SG
loukuttada	loukutan	V;IND;SG;1;POS;PRS
sein’	sein’	N;NOM;SG
kyben	kyben	N;NOM;SG
burakoine	burakoine	N;ACC;SG
märehtidä	märehtin	V;IND;SG;1;POS;PRS
nuora	nuora	N;NOM;SG
tühdä	tühdä	ADJ;ACC;SG
prikol’enii	prikol’enii	N;NOM;SG
tutkaimet	tutkaimet	N;NOM;SG
mučuu	mučuu	N;ACC;SG
ristintytär	ristintytär	N;ACC;SG
murgin	murgin	N;NOM;SG
burakko	burakko	N;NOM;SG
parzi	parzi	N;NOM;SG
hengi	hengiz	N;IN+ESS;SG
astuda	älgäh astugah	V;IMP;SG;3;NEG
bembeli	bembeli	N;ACC;SG
käžne	käžne	N;NOM;SG
puške	puške	N;ACC;SG
šügüžü	šügüžü	N;NOM;SG
löpyöi	löpyöi	N;NOM;SG
selgäpii	selgäpii	N;NOM;SG
suudida	suudin	V;IND;SG;1;POS;PRS
siived	siived	N;NOM;SG
apar	apar	N;NOM;SG
buole	buole	N;NOM;SG
zoahari	zoahari	N;NOM;SG
pezä	pezä	N;NOM;SG
mama	mama	N;NOM;SG
kubineh	kubineh	N;NOM;SG
ven’al’ažet	ven’al’ažet	N;ACC;SG
duavida	duavin	V;IND;SG;1;POS;PRS
babarm	babarm	N;ACC;SG
matk	matk	N;ACC;SG
kird’aine	kird’aine	N;ACC;SG
kukka	kukka	N;NOM;SG
kozita	kozičen	V;IND;SG;1;POS;PRS
ligakkaz	ligakkaz	ADJ;NOM;SG
pert’t’	pert’t’	N;NOM;SG
ižindam	ižindam	N;ACC;SG
zaverkke	zaverkke	N;ACC;SG
emälambas	emälambas	N;NOM;SG
vačč	vačč	N;ACC;SG
kormane	kormane	N;NOM;SG
kebdei	kebdei	ADJ;ACC;SG
kovažim	kovažim	N;NOM;SG
veičč	veičč	N;NOM;SG
keza	keza	N;NOM;SG
palke	palke	N;ACC;SG
ajel’ta	ajelen	V;IND;SG;1;POS;PRS
Viro	Viro	PROPN;ACC;SG
kindie	kindie	ADJ;ACC;SG
sana	sanad	N;NOM;PL
šüömine	šüömine	N;ACC;SG
hebočaine	hebočaine	N;ACC;SG
kihlad	kihlad	N;ACC;SG
akademii	akademii	N;ACC;SG
huiged	huiged	N;ACC;SG
seine	seine	N;ACC;SG
huavo	huavo	N;ACC;SG
varačču	varačču	N;NOM;SG
homeh	homeh	N;NOM;SG
palsta	palsta	N;NOM;SG
kaime	kaime	N;NOM;SG
kiägä	kiägä	N;ACC;SG
laškuz	laškuz	N;ACC;SG
säkki	säkki	N;NOM;SG
havu	havu	N;ACC;SG
muamo	muamo	N;ACC;SG
suai	suai	N;ACC;SG
kirjutuslaud	kirjutuslaud	N;ACC;SG
pezii	pezii	N;ACC;SG
kieletöi	kieletöi	ADJ;NOM;SG
birkaine	birkaine	N;ACC;SG
veraa	veraa	N;ACC;SG
lehme	lehme	N;NOM;SG
ystävy	ystävän	N;ACC;SG
mečče	meččih	N;IN+ALL;PL
käskyläine	käskyläine	N;NOM;SG
pakičus	pakičus	N;ACC;SG
kalalokki	kalalokki	N;NOM;SG
mulda	mulda	N;ACC;SG
sus’od	sus’od	N;ACC;SG
ohd’as	ohd’as	N;NOM;SG
oma	omas	ADJ;IN+ESS;SG
väli	väli	N;NOM;SG
lipsuttada	lipsudan	V;IND;SG;1;POS;PRS
kosič	kosič	N;NOM;SG
muzau	muzau	ADJ;NOM;SG
kirnikke	kirnikke	ADJ;ACC;SG
bramori	bramori	N;ACC;SG
basketbolkižai	basketbolkižai	N;ACC;SG
dyry	dyry	N;ACC;SG
matkalaine	matkalaine	N;ACC;SG
kavazluud	kavazluud	N;ACC;SG
talkkun	talkkun	N;NOM;SG
händ	händ	N;ACC;SG
madal	madal	N;ACC;SG
linduoi	linduoi	N;ACC;SG
meri	meri	N;ACC;SG
keväz’kuu	keväz’kuu	N;NOM;SG
lohi	lohi	N;ACC;SG
čüöttö	čüöttö	N;ACC;SG
huonnus	huonnus	N;ACC;SG
südänkerät	südänkerät	N;NOM;SG
elokuu	elokuu	N;ACC;SG
sabilahad	sabilahad	N;ACC;SG
dielo	dielo	N;ACC;SG
liipukkane	liipukkane	N;ACC;SG
Ukraina	Ukraina	PROPN;ACC;SG
guikka	guikka	N;NOM;SG
uudine	uudine	N;NOM;SG
čumučiučui	čumučiučui	N;NOM;SG
süli	süli	N;ACC;SG
selgeluu	selgeluu	N;ACC;SG
hengi	hengi	N;ACC;SG
oksakas	oksakas	ADJ;NOM;SG
leibe	leibe	N;ACC;SG
valmiš	valmiš	ADJ;ACC;SG
kiag	kiag	N;NOM;SG
ufatke	ufatke	N;NOM;SG
pil’vi	pil’vi	N;NOM;SG
raja	raja	N;NOM;SG
küpsi	küpsi	ADJ;NOM;SG
viešti	viešti	N;NOM;SG
žaleida	žiäleičen	V;IND;SG;1;POS;PRS
žurnalist	žurnalist	N;NOM;SG
pielus	pielus	N;ACC;SG
urhakas	urhakas	ADJ;ACC;SG
kaži	kažiis	N;IN+ABL;PL
kablas	kablas	N;ACC;SG
uidai	uidai	N;ACC;SG
helme	helme	N;ACC;SG
sulaime	sulaime	N;NOM;SG
kägyöi	kägyöi	N;NOM;SG
reuna	reuna	N;NOM;SG
hiihtäi	hiihtäi	N;NOM;SG
puras	puras	N;ACC;SG
nenahuogain	nenahuogain	N;NOM;SG
tuttava	tuttava	ADJ;ACC;SG
pudištada	pudištan	V;IND;SG;1;POS;PRS
rand	rand	N;NOM;SG
poud	poud	N;NOM;SG
sevuoitar	sevuoitar	N;NOM;SG
halmeh	halmeh	N;NOM;SG
enzimäneargi	enzimäneargi	N;ACC;SG
kerd	kerdan	N;FRML;SG
hill	hill	N;ACC;SG
kandates	kandates	N;ACC;SG
akka	akka	N;NOM;SG
emänd	emänd	N;NOM;SG
heltta	heltta	N;NOM;SG
püörei	püörei	ADJ;NOM;SG
mielevä	mielevä	ADJ;ACC;SG
bunukku	bunukku	N;NOM;SG
vahne	vahne	ADJ;ACC;SG
työ	työ	PRO;NOM;SG
vazaraine	vazaraine	N;ACC;SG
suolaheinä	suolaheinä	N;ACC;SG
dieduška	dieduška	N;ACC;SG
huol’	huol’	N;NOM;SG
žiželi	žiželi	N;NOM;SG
voida	vois	V;COND;SG;3;POS;PRS
sülgi	sülgi	N;ACC;SG
tuat	tuat	N;NOM;SG
laiška	laiška	ADJ;NOM;SG
liste	liste	N;ACC;SG
piätenčä	piätenčä	N;ACC;SG
čota	čota	N;NOM;SG
kuoret	kuoret	N;NOM;SG
molembat	molembat	PRO;NOM;SG
työndamiine	työndamiine	N;ACC;SG
soitand	soitand	N;ACC;SG
kego	kego	N;ACC;SG
miituine	miituine	ADJ;ACC;SG
salbamo	salbamo	N;NOM;SG
čaju	čajud	N;NOM;PL
oksa	oksa	N;NOM;SG
diäd’	diäd’	N;ACC;SG
rind	rind	N;ACC;SG
parhane	parhane	N;NOM;SG
lipas	lipas	N;NOM;SG
rugiž	rugiž	N;NOM;SG
kukuoinkuari	kukuoinkuari	N;ACC;SG
pivo	pivo	N;ACC;SG
kanbaz	kanbaz	N;ACC;SG
mägi	mägi	N;NOM;SG
hanh	hanh	N;ACC;SG
oza	oza	N;NOM;SG
verää	verää	N;ACC;SG
nogi	nogi	N;ACC;SG
mies	mies	N;NOM;SG
korpus	korpus	N;NOM;SG
tuldattoda	tuldaton	V;IND;SG;1;POS;PRS
roža	roža	N;NOM;SG
kiške	kiške	N;NOM;SG
uvažida	uvažin	V;IND;SG;1;POS;PRS
den’gat	den’gat	N;ACC;SG
bokko	bokko	N;ACC;SG
harjus	harjus	N;NOM;SG
tuohuz	tuohuz	N;ACC;SG
bezmen’	bezmen’	N;ACC;SG
trusse	trusse	N;ACC;SG
parh	parh	N;NOM;SG
oug	oug	N;NOM;SG
šuapka	šuapka	N;NOM;SG
viina	viina	N;ACC;SG
liino	liino	N;ACC;SG
kägüöintiäi	kägüöintiäi	N;NOM;SG
higi	higi	N;NOM;SG
lattii	lattii	N;NOM;SG
mülü	mülü	ADJ;NOM;SG
piraa	piraa	N;NOM;SG
sotke	sotke	N;NOM;SG
lämmö	lämmö	N;NOM;SG
šeibäz	šeibäz	N;ACC;SG
večerni	večerni	N;ACC;SG
uhk	uhk	N;ACC;SG
d’og	d’og	N;ACC;SG
sälgy	sälgy	N;ACC;SG
sončar	sončar	N;NOM;SG
kiim	kiim	N;ACC;SG
korž	korž	N;ACC;SG
iduoine	iduoine	N;ACC;SG
pruaznikk	pruaznikk	N;ACC;SG
licei	licejad	N;NOM;PL
ohvotnikke	ohvotnikke	N;NOM;SG
häin	häin	PRO;NOM;SG
mügrü	mügrü	N;NOM;SG
svuat	svuat	N;ACC;SG
pahn, pahne	pahne	N;ACC;SG
pardas	pardas	N;ACC;SG
kolakko	kolakko	N;ACC;SG
čuhuoi	čuhuoi	N;ACC;SG
palgehet	palgehet	N;ACC;SG
ogal	ogal	N;NOM;SG
mälištä	mäližen	V;IND;SG;1;POS;PRS
rebo	rebo	N;NOM;SG
palkke	palkke	N;NOM;SG
parži	parži	N;NOM;SG
britve	britve	N;ACC;SG
kanabro	kanabro	N;ACC;SG
kuok	kuok	N;ACC;SG
hond	hond	ADJ;ACC;SG
kuolenda	kuolenda	N;ACC;SG
kägöntäi	kägöntäi	N;ACC;SG
posestru	posestru	N;ACC;SG
nuage	nuage	N;ACC;SG
agano	agano	N;NOM;SG
lyydi	lyydin	ADJ;GEN;SG
vägeu	vägeu	N;NOM;SG
parž	parž	N;NOM;SG
liwhteh	liwhteh	N;NOM;SG
polude	polude	N;NOM;SG
vih’k’	vih’k’	N;NOM;SG
redke	redke	N;NOM;SG
prihač	prihač	N;NOM;SG
vojennoi	vojennoi	ADJ;NOM;SG
ogahane	ogahane	N;NOM;SG
tykke	tykke	N;NOM;SG
kengänombelii	kengänombelii	N;NOM;SG
rod	rod	N;ACC;SG
tahnus	tahnus	N;ACC;SG
vagavaane	vagavaane	ADJ;NOM;SG
sepp	sepp	N;NOM;SG
päiväne	päiväne	N;NOM;SG
huohehembi	huohehembi	ADJ;ACC;SG
alašti	alašti	ADJ;NOM;SG
dielo	dielot	N;NOM;PL
pihk	pihk	N;NOM;SG
petkel	petkel	N;NOM;SG
sablahad	sablahad	N;NOM;SG
kor’uoi	kor’uoi	N;ACC;SG
voimattomus	voimattomus	N;ACC;SG
projekt	projekt	N;ACC;SG
surme	surme	N;ACC;SG
häkk	häkk	N;ACC;SG
uudim	uudim	N;NOM;SG
muiguoitus	muiguoitus	N;NOM;SG
kučuttada	kučutan	V;IND;SG;1;POS;PRS
tedri	tedri	N;NOM;SG
tanhut	tanhut	N;NOM;SG
ilda	ilda	N;NOM;SG
hiiri	hiiri	N;NOM;SG
papp	papp	N;ACC;SG
syvä	syvä	N;NOM;SG
huaž	huaž	N;ACC;SG
Saksa	Saksa	PROPN;ACC;SG
kivos	kivos	N;ACC;SG
vieras	vieras	ADJ;NOM;SG
loškada	loškau	V;IND;SG;3;POS;PRS
voi	voi	N;NOM;SG
havad	havadoihe	N;IN+ALL;PL
meččekana	meččekana	N;NOM;SG
d’yvä	d’yvä	N;ACC;SG
suovepuu	suovepuu	N;ACC;SG
birde	birde	N;ACC;SG
poro	poro	N;ACC;SG
tihut	tihut	N;ACC;SG
purnu	purnu	N;NOM;SG
grača	grača	N;NOM;SG
taluoi	taluoi	N;NOM;SG
pakičus	pakičuksen	N;ACC;SG
vuona	vuona	N;NOM;SG
ruočid	ruočid	N;NOM;SG
arba	arba	N;NOM;SG
merda	merda	N;NOM;SG
myödäi	myödäi	N;ACC;SG
bošše	bošše	N;ACC;SG
mečče	mečikse	N;TRANS;PL
nälge	nälge	N;ACC;SG
pehu	pehu	N;ACC;SG
muzav	muzav	ADJ;NOM;SG
palkka	palkka	N;ACC;SG
kierd	kierdad	N;PRT;SG
vahalaukoi	vahalaukoi	N;ACC;SG
funte	funte	N;ACC;SG
pullo	pullo	N;NOM;SG
huodra	huodra	N;NOM;SG
meččä	meččä	N;NOM;SG
šumu	šumu	N;NOM;SG
vlasti	vlasti	N;NOM;SG
kana	kana	N;NOM;SG
laiha	laiha	ADJ;NOM;SG
kiuru	kiuru	N;ACC;SG
pühä	pühä	ADJ;NOM;SG
kämmen	kämmen	N;ACC;SG
riäde	riäde	N;ACC;SG
küps	küps	ADJ;ACC;SG
iče	iče	PRO;NOM;SG
rukk	rukk	N;NOM;SG
udostoverenii	udostoverenii	N;NOM;SG
levo	levo	N;ACC;SG
droždi	droždi	N;ACC;SG
lodm	lodm	N;ACC;SG
kabluk	kabluk	N;ACC;SG
leib	leib	N;ACC;SG
luzikk	luzikk	N;NOM;SG
huomneščaju	huomneščaju	N;ACC;SG
zautreni	zautreni	N;ACC;SG
pippuri	pippuri	N;NOM;SG
börö	börö	N;NOM;SG
tavi	tavi	N;ACC;SG
huuht	huuht	N;ACC;SG
püörd	püörd	N;NOM;SG
hamaro	hamaro	N;NOM;SG
kattil	kattil	N;ACC;SG
kiehuttada	kiehutettu	V.PTCP;PST;PASS
hämähäkki	hämähäkki	N;ACC;SG
Pyhädärvi	Pyhädärvi	PROPN;ACC;SG
voittai	voittai	N;ACC;SG
kopče	kopčad	N;NOM;PL
Espanja	Espanja	PROPN;ACC;SG
apara	apara	N;NOM;SG
čuuru	čuuru	N;NOM;SG
side	side	N;NOM;SG
tahas	tahas	N;ACC;SG
rosola	rosola	N;ACC;SG
hattarat	hattarat	N;NOM;SG
svetaine	svetaine	N;NOM;SG
orau	orau	N;NOM;SG
barde	barde	N;NOM;SG
miäre	miäre	N;ACC;SG
kulmat	kulmat	N;ACC;SG
kazinpoig	kazinpoig	N;ACC;SG
riäpüöi	riäpüöi	N;ACC;SG
pieluspiäline	pieluspiäline	N;ACC;SG
säüne	säüne	N;NOM;SG
elaige	elaige	N;NOM;SG
karjelazet	karjelazet	N;NOM;SG
ozutelii	ozutelii	N;NOM;SG
veneh	veneh	N;ACC;SG
znakke	znakke	N;NOM;SG
šiäri	šiäri	N;ACC;SG
d’umal	d’umal	N;ACC;SG
kiitos	kiitos	N;ACC;SG
sängi	sängi	N;NOM;SG
molemmin	molemmin	PRO;NOM;SG
savakko	savakko	N;NOM;SG
dividäkseh	divimmös	V;IND;SG;1;POS;PRS;REFL
siemen	siemen	N;NOM;SG
hüö	heil	PRO;AT+ESS;PL
vol’noi	vol’noi	ADJ;ACC;SG
loitoine	loitoine	ADJ;ACC;SG
edähäine	edähäine	ADJ;ACC;SG
piätinčče	piätinčče	N;ACC;SG
kabie	kabie	N;ACC;SG
basketbol	basketbol	N;ACC;SG
kudamida	kudamida	PRO;NOM;SG
karandašše	karandašše	N;NOM;SG
pind	pind	N;NOM;SG
löudande	löudande	N;NOM;SG
labido	labido	N;NOM;SG
rusket	rusket	ADJ;NOM;SG
hieno	hieno	ADJ;NOM;SG
televiizor	televiizor	N;NOM;SG
tytrindam	tytrindam	N;ACC;SG
kidžurat	kidžurat	N;ACC;SG
turist	turist	N;ACC;SG
sumke	sumke	N;ACC;SG
anze	anze	N;ACC;SG
olda	olen	V;IND;SG;1;POS;PRS
d’ärvenagd’	d’ärvenagd’	N;NOM;SG
syöttädä	suitan	V;IND;SG;1;POS;PRS
salme	salme	N;ACC;SG
laide	laide	N;NOM;SG
porohe	porohe	N;ACC;SG
pahuz	pahuz	N;ACC;SG
zavalim	zavalim	N;ACC;SG
palaane	palaane	N;NOM;SG
suovatta	suovatta	N;NOM;SG
salvo	salvo	N;ACC;SG
mečäneläi	mečäneläi	N;NOM;SG
sein’	sein’	N;ACC;SG
d’iä	d’iä	N;ACC;SG
elädä	eläy	V;IND;SG;3;POS;PRS
tuatto	tuatto	N;NOM;SG
sivut	sivut	N;NOM;SG
mieččü	mieččü	N;NOM;SG
petle	petle	N;NOM;SG
bl’uod	bl’uod	N;NOM;SG
salvo	salvospiäi	N;IN+ABL;SG
neičüt	neičüt	N;NOM;SG
molembat	molembat	PRO;ACC;SG
soim	soim	N;ACC;SG
gimnazii	gimnazii	N;NOM;SG
riäd	riäd	N;ACC;SG
mägär	mägär	N;NOM;SG
hämärä	hämärä	N;ACC;SG
totkut	totkut	N;ACC;SG
Ruočči	Ruočči	PROPN;NOM;SG
huuhta	huuhta	N;NOM;SG
palgo	palgo	N;NOM;SG
mougotid	mougotid	PRO;ACC;SG
parahin	parahin	ADJ;ACC;SG
veäre	veäre	ADJ;ACC;SG
rumen	rumen	N;NOM;SG
rosol	rosol	N;NOM;SG
notked	notked	ADJ;ACC;SG
burakko	burakko	N;ACC;SG
murgin	murgin	N;ACC;SG
räkk	räkk	N;ACC;SG
polosat	polosat	N;ACC;SG
parzi	parzi	N;ACC;SG
mägi	mäged	N;PRT;SG
hiam	hiam	N;ACC;SG
vago	vago	N;ACC;SG
pangaižet	pangaižet	N;ACC;SG
kohalline	kohalline	ADJ;ACC;SG
anupp	anupp	N;ACC;SG
tina	tina	N;NOM;SG
älü	älü	N;ACC;SG
huigie	huigie	N;ACC;SG
verkko	verkko	N;NOM;SG
se	se	PRO;ACC;SG
rusked	rusked	ADJ;ACC;SG
čirku	čirku	N;ACC;SG
kaži	kažin	N;FRML;SG
tötkud	tötkud	N;NOM;SG
säres	säres	N;ACC;SG
muile	muile	N;ACC;SG
čihve	čihve	N;ACC;SG
takka	takka	N;ACC;SG
suobat	suobatan	N;BYWAY;SG
duhu	duhu	N;NOM;SG
varačču	varačču	N;ACC;SG
ruahtoveži	ruahtoveži	N;NOM;SG
palsta	palsta	N;ACC;SG
Pyhärvi	Pyhärvi	PROPN;NOM;SG
zvonke	zvonke	N;ACC;SG
härge	härge	N;ACC;SG
peld	peld	N;NOM;SG
mogil	mogil	N;NOM;SG
rahvas	rahvas	N;NOM;SG
siib	siib	N;NOM;SG
lautte	lautte	N;NOM;SG
žurnual	žurnual	N;NOM;SG
herneh	herneh	N;NOM;SG
villa	villa	N;NOM;SG
soker	soker	N;ACC;SG
takke	takke	N;ACC;SG
kalmižmua	kalmižmua	N;ACC;SG
karandaša	karandaša	N;ACC;SG
kaid	kaid	ADJ;ACC;SG
ahtaz	ahtaz	ADJ;ACC;SG
vuapsahane	vuapsahane	N;NOM;SG
pačku	pačku	N;NOM;SG
viertä	vieren	V;IND;SG;1;POS;PRS
tyl’če	tyl’če	ADJ;NOM;SG
varu	varu	N;NOM;SG
lehme	lehme	N;ACC;SG
mujeh	mujeh	N;ACC;SG
ned	ned	PRO;ACC;SG
voimatuoine	voimatuoine	ADJ;NOM;SG
virga	virga	N;NOM;SG
kylä	kylä	N;NOM;SG
kuavi	kuavi	N;NOM;SG
ižändä	ižändä	N;ACC;SG
liiga	liiga	ADJ;NOM;SG
kuošk	kuošk	N;NOM;SG
ristinpoig	ristinpoig	N;NOM;SG
kyl’bkost’um	kyl’bkost’um	N;NOM;SG
haugot	haugot	N;NOM;SG
bl’uud’ečke	bl’uud’ečke	N;NOM;SG
ujel’tä	ujelen	V;IND;SG;1;POS;PRS
penzii	penzii	N;ACC;SG
koja	koja	N;ACC;SG
sčokka	sčokka	N;ACC;SG
küühküine	küühküine	N;ACC;SG
kartt	kartt	N;ACC;SG
toppe	toppe	N;ACC;SG
obdelke	obdelke	N;NOM;SG
priimida	priimin	V;IND;SG;1;POS;PRS
suolotuoi	suolotuoi	N;NOM;SG
suurim	suurim	N;ACC;SG
mua	muad	N;IN+ESS;SG
ruozmi	ruozmi	N;NOM;SG
madeh	madeh	N;NOM;SG
kaskes	kaskes	N;NOM;SG
yksi	yhte	NUM;PRT;SG
rinde	rinde	N;NOM;SG
rugo	rugo	N;NOM;SG
hurstiine	hurstiine	N;ACC;SG
rajakko	rajakko	N;ACC;SG
aiga	aiga	N;ACC;SG
zatinke	zatinke	N;ACC;SG
truatte	truatte	N;ACC;SG
laučč	laučč	N;ACC;SG
lappa	lappa	N;NOM;SG
numer	numer	N;NOM;SG
kägentiäi	kägentiäi	N;ACC;SG
böröi	böröi	N;ACC;SG
puara	puara	N;NOM;SG
kuva	kuva	N;NOM;SG
st’okle	st’okle	N;NOM;SG
ufatke	ufatke	N;ACC;SG
sumeg	sumeg	N;ACC;SG
kiag	kiag	N;ACC;SG
pil’vi	pil’vi	N;ACC;SG
tuluppe	tuluppe	N;ACC;SG
huodr	huodr	N;ACC;SG
torba	torba	N;ACC;SG
pino	pino	N;ACC;SG
vezirista	vezirista	N;ACC;SG
räüšköt	räüšköt	N;ACC;SG
kandapiä	kandapiä	N;ACC;SG
mahanker	mahanker	ADJ;NOM;SG
laiška	laiška	ADJ;ACC;SG
maha	maha	N;ACC;SG
fufaike	fufaike	N;NOM;SG
laukku	laukku	N;NOM;SG
kuukiš	kuukiš	N;ACC;SG
kazakke	kazakke	N;NOM;SG
pohked	pohked	N;NOM;SG
ristikanza	ristikanza	N;ACC;SG
rikat	rikat	N;ACC;SG
vagav	vagav	ADJ;ACC;SG
ostai	ostai	N;ACC;SG
maho	maho	ADJ;NOM;SG
petkel’	petkel’	N;NOM;SG
hapaimaido	hapaimaido	N;NOM;SG
katuz	katuz	N;NOM;SG
lötüöi	lötüöi	N;NOM;SG
suatto	suatto	N;ACC;SG
staruuha	staruuha	N;ACC;SG
pualikke	pualikke	N;NOM;SG
ostada	ostan	V;IND;SG;1;POS;PRS
ferezi	ferezi	N;NOM;SG
čiučui	čiučui	N;ACC;SG
veräjä	veräjä	N;ACC;SG
kuoret	kuoret	N;ACC;SG
čota	čota	N;ACC;SG
ezmažarg	ezmažargen	N;BYWAY;SG
kallehembi	kallehembi	ADJ;ACC;SG
puatoke	puatoke	N;ACC;SG
miel’	miel’	N;NOM;SG
buat’kuu	buat’kuu	N;NOM;SG
muigotes	muigotes	N;NOM;SG
rokk	rokk	N;ACC;SG
mina	mina	PRO;NOM;SG
kidžu	kidžu	N;NOM;SG
ščipčad	ščipčad	N;NOM;SG
razavhine	razavhine	ADJ;NOM;SG
keväz’	keväz’	N;NOM;SG
suahari	suahari	N;NOM;SG
kiiže	kiiže	N;NOM;SG
himoittada	himoitan	V;IND;SG;1;POS;PRS
pačaz	pačaz	N;ACC;SG
sroičanpäiv	sroičanpäiv	N;NOM;SG
pil’vezus	pil’vezus	N;ACC;SG
muruine	muruine	N;ACC;SG
varačču	varačču	ADJ;NOM;SG
ola	ola	N;ACC;SG
kihlat	kihlat	N;ACC;SG
särgi	särgi	N;NOM;SG
d’alg	d’algah	N;IN+ALL;SG
lattii	lattii	N;ACC;SG
kägüöintiäi	kägüöintiäi	N;ACC;SG
tusk	tusk	N;ACC;SG
rehto	rehto	N;ACC;SG
tehnikum	tehnikum	N;NOM;SG
hypästädä	hypästi	V;IPFV;IND;SG;3;POS;PST
Kažinpäive	Kažinpäive	PROPN;NOM;SG
čabero	čabero	N;ACC;SG
rüžä	rüžä	N;ACC;SG
mehiläine	mehiläine	N;NOM;SG
paide	paide	N;ACC;SG
vojuita	vojuičen	V;IND;SG;1;POS;PRS
aparod	aparod	N;ACC;SG
polos	polos	N;ACC;SG
pinda	pinda	N;ACC;SG
kuld	kuld	N;ACC;SG
löytä	löyzi	V;IPFV;IND;SG;3;POS;PST
ležanke	ležanke	N;ACC;SG
nasmork	nasmork	N;ACC;SG
huahmuoi	huahmuoi	N;NOM;SG
metle	metle	N;NOM;SG
kai	kai	PRO;ACC;SG
komšše	komšše	N;NOM;SG
händikäs	händikäs	N;ACC;SG
šieni	šieni	N;NOM;SG
suolhein	suolhein	N;NOM;SG
tähti	tähti	N;NOM;SG
bratan	bratan	N;ACC;SG
pedre	pedre	N;NOM;SG
pruaznikke	pruaznikke	N;ACC;SG
taltta	taltta	N;ACC;SG
borčče	borčče	N;ACC;SG
matkusumk	matkusumk	N;ACC;SG
šäigiš	šäigiš	N;ACC;SG
dyged	Dygedah	ADJ;IN+ALL;SG
kubineh	kubineh	N;ACC;SG
sort	sort	N;ACC;SG
divan	divan	N;ACC;SG
babke	babke	N;NOM;SG
sabalagat	sabalagat	N;NOM;PL
koukk	koukk	N;ACC;SG
harakke	harakke	N;ACC;SG
t’ädi	t’ädi	N;NOM;SG
sägä	sägä	N;ACC;SG
meččälaine	meččälaine	N;NOM;SG
nado	nado	N;ACC;SG
pahuz	pahusiis	N;IN+ABL;PL
emälambas	emälambas	N;ACC;SG
veičč	veičč	N;ACC;SG
kovažim	kovažim	N;ACC;SG
lihašmötk	lihašmötk	N;NOM;SG
palkke	palkke	N;ACC;SG
sirotin	sirotin	N;NOM;SG
uaskonda	uaskonda	N;NOM;SG
saraffan	saraffan	N;NOM;SG
emändim	emändim	N;NOM;SG
mužik	mužik	N;NOM;SG
redke	redke	N;ACC;SG
kuopp	kuopp	N;NOM;SG
pakkane	pakkane	N;NOM;SG
vih’k’	vih’k’	N;ACC;SG
prihač	prihač	N;ACC;SG
očče	očče	N;NOM;SG
omad	oman	N;FRML;SG
aštiet	aštiet	N;ACC;SG
vasta	vasta	N;ACC;SG
kiel’	kiel’te	N;PRT;SG
mölgettädä	mölgеtin	V;IND;SG;1;POS;PRS
molemmin	molemmin	PRO;ACC;SG
aide	aide	N;ACC;SG
igen	igenet	N;NOM;PL
armastada	armastan	V;IND;SG;1;POS;PRS;REFL
šepp	šepp	N;ACC;SG
vägöv	vägöv	ADJ;NOM;SG
ripšu	ripšu	N;NOM;SG
luzikke	luzikke	N;NOM;SG
härkim	härkim	N;NOM;SG
strannike	strannike	N;NOM;SG
koufkuoit	koufkuoit	N;NOM;SG
müö	müö	PRO;ACC;SG
kalalokki	kalalokki	N;ACC;SG
raht	raht	N;NOM;SG
osse	osse	N;ACC;SG
ohd’as	ohd’as	N;ACC;SG
materij	materij	N;ACC;SG
varuu	varuu	N;ACC;SG
velga	velga	N;NOM;SG
kušakke	kušakke	N;NOM;SG
ilda	ilda	N;ACC;SG
hiiri	hiiri	N;ACC;SG
alužim	alužim	N;NOM;SG
urakke	urakke	N;NOM;SG
kudei	kudei	N;ACC;SG
uks’	uks’	N;ACC;SG
kaššal’	kaššal’	N;ACC;SG
mečče	meččäh	N;IN+ALL;SG
kopeikka	kopeikka	N;ACC;SG
armo	armo	N;ACC;SG
slifkad	slifkad	N;ACC;SG
valatti	valatti	N;NOM;SG
lüüdiküöit	lüüdiküöit	N;NOM;SG
tabavoida	tabavoin	V;IND;SG;1;POS;PRS
kudai	kudaman	PRO;GEN;SG
kuundel’ta	kundelen	V;IND;SG;1;POS;PRS
hitroi	hitroi	ADJ;NOM;SG
kuolii	kuolii	ADJ;ACC;SG
čorte	čorte	N;NOM;SG
hitrii	hitrii	ADJ;NOM;SG
urok	urok	N;NOM;SG
taluoi	taluoit	N;NOM;PL
pullo	pullo	N;ACC;SG
riehtil	riehtil	N;ACC;SG
ünnälliine	ünnälliine	N;NOM;SG
gimnastiekk	gimnastiekk	N;NOM;SG
lešuoi	lešuoi	N;ACC;SG
kard’alažet	kard’alažet	N;NOM;SG
hüubüö	hüubüö	N;NOM;SG
oma	oma	PRO;NOM;SG
koivungriba	koivungriba	N;NOM;SG
nahkasiibi	nahkasiibi	N;NOM;SG
aid	aid	N;NOM;SG
čuas	čuas	N;ACC;SG
päivänlask	päivänlask	N;NOM;SG
kopeikke	kopeikke	N;NOM;SG
anoppi	anoppi	N;NOM;SG
röünääne	röünääne	N;ACC;SG
talte	talte	N;NOM;SG
stroičča	stroičča	N;NOM;SG
izre	izre	N;NOM;SG
dälgimbäne	dälgimbäne	ADJ;NOM;SG
korvatuoi	korvatuoi	ADJ;NOM;SG
vihaine	vihaine	ADJ;ACC;SG
hmel’u	hmel’u	N;ACC;SG
börö	börö	N;ACC;SG
pruaznikka	pruaznikka	N;NOM;SG
siige	siige	N;NOM;SG
kives	kives	N;NOM;SG
viledä	vileu	V;IND;SG;1;POS;PRS
d’uoksendelda	d’uoksendelen	V;IND;SG;1;POS;PRS
laštvod	laštvod	N;NOM;SG
salmi	salmi	N;NOM;SG
kova	kova	ADJ;ACC;SG
rand	rand	N;ACC;SG
gr’adke	gr’adke	N;NOM;SG
rikki	rikki	N;ACC;SG
raukke	raukke	N;ACC;SG
magaduspert’	magaduspert’	N;NOM;SG
rikkovo	rikkovo	N;NOM;SG
rukki	rukki	N;NOM;SG
ville	ville	N;NOM;SG
vara	vara	N;NOM;SG
präške	präške	N;NOM;SG
d’algačim	d’algačim	N;ACC;SG
kangashagot	kangashagot	N;ACC;SG
kaiv	kaiv	N;ACC;SG
huaže	huaže	N;NOM;SG
palaine	palaine	N;ACC;SG
pakkuli	pakkuli	N;NOM;SG
bank	bank	N;NOM;SG
vate	vate	N;ACC;SG
huuli	huulet	N;NOM;PL
čihl	čihl	N;NOM;SG
nurmi	nurmi	N;ACC;SG
tähke	tähke	N;ACC;SG
raida	raida	N;ACC;SG
pajanik	pajanik	N;ACC;SG
ozutelii	ozutelii	N;ACC;SG
karjelazet	karjelazet	N;ACC;SG
arbuoitus	arbuoitus	N;ACC;SG
lagevus	lagevus	N;ACC;SG
sanoma	sanoma	N;NOM;SG
pičukkane	pičukkane	ADJ;ACC;SG
ekipaž	ekipaž	N;NOM;SG
barb	barb	N;NOM;SG
kosmič	kosmič	N;NOM;SG
počči	počči	N;NOM;SG
ruahtovezi	ruahtovezi	N;NOM;SG
ruame	ruame	N;ACC;SG
oks	oks	N;ACC;SG
madoine	madoine	N;ACC;SG
pideltä	pideltih	V;IPFV;IND;PL;3;POS;PST;REFL
savakko	savakko	N;ACC;SG
minä	minun	PRO;ACC;SG
ardo	ardo	N;NOM;SG
biatlonist	biatlonist	N;NOM;SG
kägentäi	kägentäi	N;NOM;SG
hauda	hauda	N;NOM;SG
suabr	suabr	N;ACC;SG
enzimäineargi	enzimäineargi	N;ACC;SG
čer’kou	čer’kou	N;ACC;SG
viehh	viehh	N;ACC;SG
d’allačče	d’allačče	N;NOM;SG
astuda	astui	V;IPFV;IND;SG;3;POS;PST
kagle	kagle	N;NOM;SG
krupnii	krupnembi	ADJ;NOM;SG
mikse	mikse	PRO;NOM;SG
pirg	pirg	N;ACC;SG
Brus’a	Brus’a	PROPN;ACC;SG
karandašše	karandašše	N;ACC;SG
kuhn’e	kuhn’al	N;AT+ESS;SG
kuom	kuom	N;ACC;SG
syvä	syvä	ADJ;NOM;SG
tukkunaine	tukkunaine	ADJ;ACC;SG
konztahto	konztahto	PRO;ACC;SG
piirua	piirua	N;NOM;SG
lykkidä	lykin	V;IND;SG;1;POS;PRS
počkad	počkad	N;ACC;SG
d’ärvenagd’	d’ärvenagd’	N;ACC;SG
käveltä	käveli	V;IPFV;IND;SG;3;POS;PST
šär’v	šär’v	N;NOM;SG
suomilažet	suomilažet	N;NOM;SG
igäv	igäv	N;NOM;SG
pikkurane	pikkurane	ADJ;ACC;SG
rodukund	rodukund	N;NOM;SG
notked	notked	ADJ;NOM;SG
ohjakset	ohjakset	N;NOM;SG
onginiitiine	onginiitiine	N;NOM;SG
kablaz	kablaz	N;ACC;SG
suomus	suomus	N;ACC;SG
peldovaroi	peldovaroi	N;NOM;SG
kuuzi	kuuzi	N;ACC;SG
šäkki	šäkki	N;NOM;SG
kal’žut	kal’žut	N;NOM;SG
suga	suga	N;ACC;SG
huodar	huodar	N;ACC;SG
pimed	pimed	ADJ;NOM;SG
lukuta	lukkudan	V;IND;SG;1;POS;PRS
kuhmu	kuhmu	N;ACC;SG
pelvas	pelvas	N;ACC;SG
elände	elände	N;ACC;SG
sarai	sarai	N;ACC;SG
mandžuoi	mandžuoi	N;ACC;SG
kušak	kušak	N;NOM;SG
biibuo	biibuo	N;ACC;SG
tabletk	tabletk	N;NOM;SG
kanzalližuus	kanzalližuus	N;NOM;SG
kiiškot	kiiškot	N;NOM;SG
fakul’tet	fakul’tet	N;NOM;SG
kuničča	kuničča	N;ACC;SG
vaguoi	vaguoi	N;ACC;SG
agano	agano	N;ACC;SG
parž	parž	N;ACC;SG
liwhteh	liwhteh	N;ACC;SG
sündummua	sündummua	N;ACC;SG
rumen	rumen	N;ACC;SG
buku	buku	N;ACC;SG
rosol	rosol	N;ACC;SG
piirag	piirag	N;NOM;SG
sija	sija	N;ACC;SG
agj	agj	N;ACC;SG
tiešuaraine	tiešuaraine	N;ACC;SG
hoik	hoik	ADJ;NOM;SG
agan	agan	N;ACC;SG
emindämä	emindämä	N;NOM;SG
hambas	hambas	N;ACC;SG
kerd	kerd	N;ACC;SG
sirdel’tä	sirdelen	V;IND;SG;1;POS;PRS
kukko	kukko	N;NOM;SG
meččuo	meččuo	N;NOM;SG
hyö	hyö	PRO;ACC;SG
luzik	luzik	N;NOM;SG
moine	moine	ADJ;NOM;SG
hägärä	hägärä	N;NOM;SG
kägi	kägi	N;NOM;SG
ižand	ižandad	N;NOM;PL
kaida	kaida	ADJ;ACC;SG
kilometr	kilometr	N;NOM;SG
kuolend	kuolend	N;NOM;SG
zontikke	zontikke	N;ACC;SG
näppi	näppi	N;ACC;SG
čirgat	čirgat	N;ACC;SG
sugaz	sugaz	N;ACC;SG
vihm	vihm	N;ACC;SG
vihk	vihk	N;NOM;SG
žurnual	žurnual	N;ACC;SG
ilde	ilde	N;NOM;SG
herneh	herneh	N;ACC;SG
rinnus	rinnus	N;NOM;SG
kartta	kartta	N;ACC;SG
huahmoi	huahmoi	N;ACC;SG
ragiž	ragiž	N;ACC;SG
mädähn	mädähn	N;ACC;SG
kuccuda	en kucu	V;IND;SG;1;NEG;PRS
grohot	grohot	N;NOM;SG
nävärgäine	nävärgäine	N;NOM;SG
leuge	leuge	N;NOM;SG
orla	orla	N;ACC;SG
hinde	hinde	N;NOM;SG
lötöt	lötöt	N;NOM;SG
ruaht	ruaht	N;ACC;SG
viest’	viest’	N;ACC;SG
mänd	mänd	N;NOM;SG
ad’v	ad’v	N;NOM;SG
huonduz	huonduz	N;NOM;SG
särge	särge	N;NOM;SG
liuhtes	liuhtes	N;ACC;SG
toukke	toukke	N;ACC;SG
bokk	bokk	N;ACC;SG
sammal	sammal	N;NOM;SG
riäpüö	riäpüö	N;NOM;SG
urke	urke	N;NOM;SG
painoatletik	painoatletik	N;NOM;SG
petkeli	petkeli	N;NOM;SG
ušte	ušte	N;NOM;SG
muzava	muzava	ADJ;ACC;SG
kurgi	kurgi	N;ACC;SG
toine	toižeh	ADJ;IN+ALL;SG
obdelke	obdelke	N;ACC;SG
myönde	myönde	N;NOM;SG
lang	lang	N;NOM;SG
rassol	rassol	N;NOM;SG
luu	luu	N;NOM;SG
suolotuoi	suolotuoi	N;ACC;SG
höyhen	höyhen	N;ACC;SG
rugiš	rugiš	N;NOM;SG
soba	soba	N;NOM;SG
künäbrüs	künäbrüs	N;NOM;SG
siened	siened	N;NOM;SG
suobatte	suobatte	N;ACC;SG
tukk	tukk	N;ACC;SG
pordahad	pordahad	N;NOM;PL
garbol	garbol	N;NOM;SG
bembel	bembel	N;NOM;SG
kuumad	kuumad	N;NOM;SG
pogoste	pogoste	N;NOM;SG
puara	puara	N;ACC;SG
kuva	kuva	N;ACC;SG
pl’en	pl’enah	N;IN+ALL;SG
tuukkaja	tuukkaja	N;NOM;SG
svetofor	svetofor	N;NOM;SG
oltari	oltari	N;NOM;SG
dorošk	dorošk	N;NOM;SG
vezi	vezi	N;NOM;SG
vel’l’	vel’l’et	N;NOM;PL
skorca	skorca	N;ACC;SG
gajakk	gajakk	N;NOM;SG
buzat	buzat	N;ACC;SG
kyzyndlist	kyzyndlist	N;ACC;SG
olda	emme olnuiš	V;IPFV;COND;PL;1;NEG;PST
piiluine	piiluine	N;NOM;SG
dälgi	dälgi	N;NOM;SG
arššina	arššina	N;NOM;SG
riäpöi	riäpöi	N;NOM;SG
biibal	biibal	N;ACC;SG
dorog	dorog	N;NOM;SG
sulga	sulga	N;NOM;SG
ast’uoid	ast’uoid	N;NOM;SG
kirvez	kirvez	N;NOM;SG
nimenpanemiine	nimenpanemiine	N;NOM;SG
sukk	sukk	N;ACC;SG
ut’ug	ut’ug	N;ACC;SG
orau	orau	N;ACC;SG
barde	barde	N;ACC;SG
kuldoi	kuldoi	N;NOM;SG
päčnikke	päčnikke	N;NOM;SG
läzijä	läzijä	ADJ;ACC;SG
lyydi	lyydi	ADJ;ACC;SG
mieli	mieled	N;NOM;PL
ristižä	ristižä	N;NOM;SG
kuav	kuav	N;NOM;SG
priha	priha	N;NOM;SG
selgäruoda	selgäruoda	N;NOM;SG
dyrk	dyrkke	ADJ;NOM;SG
rambe	rambe	ADJ;ACC;SG
kilometr	kilometrid	N;NOM;PL
izvesti	izvesti	N;NOM;SG
kassa	kassa	N;NOM;SG
luistelu	luistelu	N;NOM;SG
hukke	hukke	N;NOM;SG
täüz	täüz	N;NOM;SG
suksi	suksi	N;NOM;SG
kanda	kanda	N;NOM;SG
pihka	pihka	N;NOM;SG
täüziigäine	täüziigäine	ADJ;ACC;SG
kurneh	kurneh	ADJ;ACC;SG
varačču	varačču	ADJ;ACC;SG
nork	nork	N;ACC;SG
tuhk	tuhk	N;ACC;SG
šülgi	šülgi	N;ACC;SG
vahne	vahnas	ADJ;IN+ESS;SG
rahmannoi	rahmannoi	ADJ;NOM;SG
buat’kuu	buat’kuu	N;ACC;SG
muigotes	muigotes	N;ACC;SG
tuohus	tuohus	N;ACC;SG
mečče	mečäl	N;AT+ESS;SG
puuhine	puuhižes	ADJ;IN+ESS;SG
praude	praude	N;NOM;SG
sume	sume	N;NOM;SG
puhas	puhas	ADJ;NOM;SG
uuš	uuš	ADJ;ACC;SG
nel’likke	nel’likke	N;NOM;SG
aspirant	aspirantad	N;PRT;SG
korde	korde	N;ACC;SG
kauh	kauh	N;ACC;SG
käpče	käpče	N;ACC;SG
kylmkuu	kylmkuu	N;ACC;SG
täpin	täpin	N;ACC;SG
sogie	sogie	ADJ;NOM;SG
škola	školaz	N;IN+ESS;SG
kida	kida	N;NOM;SG
kulo	kulo	N;NOM;SG
nevesk	nevesk	N;NOM;SG
kaži	kažid	N;NOM;PL
sorminahk	sorminahk	N;ACC;SG
naba	naba	N;ACC;SG
suatt	suatt	N;NOM;SG
kirppu	kirppu	N;NOM;SG
merk	merk	N;ACC;SG
pedra	pedra	N;NOM;SG
miske	miske	N;NOM;SG
savu	savu	N;NOM;SG
šiä	šiä	N;NOM;SG
sdače	sdače	N;NOM;SG
kadomine	kadomine	N;ACC;SG
rouga	rouga	N;ACC;SG
pedre	pedre	N;ACC;SG
tähti	tähti	N;ACC;SG
kulak	kulak	N;NOM;SG
sotk	sotk	N;ACC;SG
kuori	kuori	N;ACC;SG
hattaro	hattaro	N;ACC;SG
kiotte	kiotte	N;ACC;SG
birbi	birbi	N;ACC;SG
suolhein	suolhein	N;ACC;SG
espanjalaine	espanjalaine	N;NOM;SG
ahavo	ahavo	N;NOM;SG
lidn	lidnas	N;IN+ESS;SG
drožžit	drožžit	N;NOM;SG
kier	kier	N;NOM;SG
meččälaine	meččälaine	N;ACC;SG
sydidä	sydin	V;IND;SG;1;POS;PRS
karged	karged	ADJ;NOM;SG
mučukke	mučukke	N;ACC;SG
agd’e	agd’e	N;ACC;SG
paid	paid	N;ACC;SG
merkki	merkki	N;ACC;SG
tuoreh	tuoreh	ADJ;NOM;SG
uušte	uušte	N;ACC;SG
čihkoi	čihkoi	N;ACC;SG
muigoites	muigoites	N;ACC;SG
ajande	ajande	N;ACC;SG
palkk	palkk	N;ACC;SG
mužik	mužik	N;ACC;SG
n’aba	n’aba	N;ACC;SG
pehmie	pehmie	ADJ;NOM;SG
kaste	kaste	N;NOM;SG
alasti	alasti	ADJ;NOM;SG
šliap	šliap	N;NOM;SG
ruohk	ruohk	ADJ;NOM;SG
garbalo	garbalo	N;NOM;SG
ruoppaz	ruoppaz	N;ACC;SG
karžin	karžin	N;ACC;SG
kolmašpäivä	kolmašpäivä	N;NOM;SG
redustada	redustan	V;IND;SG;1;POS;PRS
parz’	parz’	N;ACC;SG
hong	hong	N;NOM;SG
rago	rago	N;NOM;SG
lauk	lauk	N;NOM;SG
miär	miär	N;NOM;SG
pert’lomud	pert’lomud	N;ACC;SG
vedida	vedin	V;IND;SG;1;POS;PRS
velga	velga	N;ACC;SG
kušakke	kušakke	N;ACC;SG
viehke	viehke	N;ACC;SG
paltin	paltin	N;NOM;SG
Suomi	Suomi	PROPN;NOM;SG
ruskičč	ruskičč	N;ACC;SG
bual	bual	N;ACC;SG
ruadomatk	ruadomatk	N;ACC;SG
höštekogo	höštekogo	N;ACC;SG
voibruusoi	voibruusoi	N;ACC;SG
ambujaine	ambujaine	N;ACC;SG
ristinpoig	ristinpoig	N;ACC;SG
kuošk	kuošk	N;ACC;SG
olda	oližimme	V;IPFV;COND;PL;1;POS;PST
mašin	mašin	N;ACC;SG
ukonkuari	ukonkuari	N;NOM;SG
voimatus	voimatus	N;NOM;SG
velle	velle	N;NOM;SG
pendu	pendu	N;ACC;SG
laukke	laukke	N;NOM;SG
palle	palle	N;NOM;SG
kand	kand	N;NOM;SG
orahat	orahat	N;NOM;SG
kartohk	kartohk	N;NOM;SG
labid	labid	N;NOM;SG
tihie	tihie	ADJ;NOM;SG
haižuda	haižun	V;IND;SG;1;POS;PRS
vargastada	vargastan	V;IND;SG;1;POS;PRS
raudad	raudad	N;ACC;SG
emag	emag	N;ACC;SG
tal’v	tal’vel	N;AT+ESS;SG
huomez	huomez	N;ACC;SG
muuruo	muuruo	N;NOM;SG
murčukke	murčukke	N;NOM;SG
lähtömä	lähtömä	N;ACC;SG
žoltuhe	žoltuhe	N;ACC;SG
samaigähiine	samaigähiine	N;NOM;SG
uros	uros	N;NOM;SG
pilluine	pilluine	N;NOM;SG
uglahin’e	uglahin’e	ADJ;NOM;SG
puoli	puoli	N;NOM;SG
tr’aske	tr’aske	N;ACC;SG
arbe	arbe	N;ACC;SG
bobra	bobra	N;ACC;SG
hiema	hiema	N;ACC;SG
birä	birä	N;NOM;SG
süöm	süöm	N;NOM;SG
kajuoi	kajuoi	N;NOM;SG
šižme	šižme	N;ACC;SG
kyndžidä	kyndžin	V;IND;SG;1;POS;PRS
harav	harav	N;NOM;SG
poštud’aššik	poštud’aššik	N;NOM;SG
ait	ait	N;ACC;SG
tazane	tazane	ADJ;NOM;SG
kondii	kondii	N;NOM;SG
biegluoi	biegluoi	N;NOM;SG
pappi	pappi	N;NOM;SG
azrain	azrain	N;NOM;SG
kuurnis	kuurnis	ADJ;NOM;SG
piilo	piilo	N;NOM;SG
varaita	varaidan	V;IND;SG;1;POS;PRS
kilbailu	kilbailu	N;ACC;SG
ora	ora	N;ACC;SG
idi	idi	N;ACC;SG
sulaimi	sulaimi	N;ACC;SG
anoppi	anoppi	N;ACC;SG
talte	talte	N;ACC;SG
stroičča	stroičča	N;ACC;SG
kerd	kerdal	N;AT+ESS;SG
st’okle	st’okle	N;ACC;SG
brigadir	brigadir	N;NOM;SG
keruo	keruo	N;NOM;SG
aid	aid	N;ACC;SG
ruumen	ruumen	N;NOM;SG
kuokka	kuokka	N;NOM;SG
hašk	hašk	N;NOM;SG
gribe	gribe	N;NOM;SG
kourišk	kourišk	N;NOM;SG
kajag	kajag	N;NOM;SG
muččo	muččo	N;NOM;SG
vigli	vigli	N;ACC;SG
ven’alaižet	ven’alaižet	N;ACC;SG
seibäs	seibäs	N;NOM;SG
nuužnik	nuužnik	N;NOM;SG
kazakke	kazakke	N;ACC;SG
tark	tark	ADJ;NOM;SG
pohked	pohked	N;ACC;SG
varba	varba	N;ACC;SG
kagre	kagre	N;NOM;SG
nelläšpäiv	nelläšpäiv	N;ACC;SG
liäve	liäve	N;NOM;SG
uzohtin	uzohtin	N;NOM;SG
kaida	kaida	ADJ;NOM;SG
vonguda	vongun	V;IND;SG;1;POS;PRS
arbadus	arbadus	N;NOM;SG
perednikke	perednikke	N;NOM;SG
hobie	hobie	N;NOM;SG
kuurič	kuurič	N;ACC;SG
grammatik	grammatik	N;ACC;SG
kattila	kattila	N;NOM;SG
huahmuoi	huahmuoi	ADJ;NOM;SG
nuoli	nuoli	N;ACC;SG
golub	golub	N;ACC;SG
muaemä	muaemä	N;ACC;SG
žalob	žalob	N;NOM;SG
kivez	kivez	N;NOM;SG
keskuč	keskuč	N;NOM;SG
sanoma	sanoma	N;ACC;SG
ekipaž	ekipaž	N;ACC;SG
muurahane	muurahane	N;ACC;SG
oraane	oraane	N;NOM;SG
ambari	ambari	N;NOM;SG
vilu	vilud	N;PRT;SG
šinä	šinä	PRO;ACC;SG
pikkurane	pikkurane	ADJ;NOM;SG
ahkut	ahkut	N;NOM;SG
ruad	ruad	N;NOM;SG
stameske	stameske	N;NOM;SG
alužin	alužin	N;NOM;SG
stol’ari	stol’ari	N;ACC;SG
viehe	viehe	N;ACC;SG
gor’ašši	gor’ašši	N;ACC;SG
kirvezmiez’	kirvezmiez’	N;ACC;SG
tuah	tuah	N;ACC;SG
korbi	korbi	N;ACC;SG
liipoi	liipoi	N;ACC;SG
paras	paras	ADJ;ACC;SG
kosmič	kosmič	N;ACC;SG
kägentäi	kägentäi	N;ACC;SG
t’aža	t’aža	N;ACC;SG
biatlonist	biatlonist	N;ACC;SG
märgä	märgä	N;NOM;SG
piha	piha	N;NOM;SG
terve	terve	N;NOM;SG
astuda	astužitte	V;COND;PL;2;POS;PRS
kuudaine	kuudaine	N;ACC;SG
briha	briha	N;ACC;SG
ilo	ilo	N;NOM;SG
treščotke	treščotke	N;NOM;SG
hummar	hummar	N;NOM;SG
tihi	tihi	N;NOM;SG
kal’džut	kal’džut	N;NOM;SG
miär’	miär’	N;ACC;SG
lastušk	lastušk	N;NOM;SG
merkičus	merkičukses	N;IN+ABL;SG
borčuiččii	borčuiččii	N;NOM;SG
üöleivoi	üöleivoi	N;ACC;SG
hambahaine	hambahaine	N;NOM;SG
kuldankarvaane	kuldankarvaane	ADJ;NOM;SG
kürz	kürz	N;ACC;SG
pügäl	pügäl	N;ACC;SG
kerda	kerda	N;NOM;SG
sizar	sizared	N;NOM;PL
žadnuoi	žadnuoi	N;ACC;SG
ženihhe	ženihhe	N;NOM;SG
udžve	udžve	N;NOM;SG
miäčč	miäčč	N;NOM;SG
mitüs	mitüs	PRO;NOM;SG
kohtune	kohtune	ADJ;ACC;SG
