framr	fremstu	ADJ;NOM;SPRL;MASC;PL;LGSPEC02
døkkr	døkkvasti	ADJ;NOM;SPRL;MASC;SG;LGSPEC02
kaupa	keyptuzk	V;IND;PL;2;PST;MID+PASS;LGSPEC02
kveða	kváðuzk	V;IND;PL;2;PST;MID+PASS;LGSPEC01
svima	svimaða	V;SBJV;SG;1;PST;ACT;LGSPEC02
hrukka	hrukknanna	N;GEN;DEF;FEM;PL
eisa	eisur	N;ACC;INDF;FEM;PL
toga	toga	V;NFIN;ACT;LGSPEC02
framr	framastra	ADJ;GEN;SPRL;MASC;PL;LGSPEC01
gamall	ellztr	ADJ;NOM;SPRL;MASC;SG;LGSPEC01
háss	hásasta	ADJ;NOM;SPRL;NEUT;SG;LGSPEC02
hryggr	hryggvasta	ADJ;GEN;SPRL;MASC;SG;LGSPEC02
spjall	spjǫllin	N;ACC;DEF;NEUT;PL
gǫngull	gǫnglustum	ADJ;DAT;SPRL;MASC;SG;LGSPEC01
skilinn	skilinni	V.PTCP;DAT;FEM;SG;LGSPEC01
verða	yrðir	V;SBJV;SG;2;PST;ACT;LGSPEC01
hreiðr	hreiðrinu	N;DAT;DEF;NEUT;SG
sjóða	suðuzk	V;IND;PL;2;PST;MID+PASS;LGSPEC01
yfirkoma	yfirkomum	V;IND;PL;1;PRS;ACT;LGSPEC01
athugasamr	athugasamastri	ADJ;DAT;SPRL;FEM;SG;LGSPEC01
yfirgefa	yfirgefisk	V;SBJV;SG;3;PRS;MID+PASS;LGSPEC01
lægja	lægisk	V;SBJV;PL;3;PRS;MID+PASS;LGSPEC02
alheiðinn	alheiðnustu	ADJ;GEN;SPRL;MASC;PL;LGSPEC02
grána	gránizk	V;IMP;PL;2;PRS;MID+PASS;LGSPEC02
leikligr	leikligustu	ADJ;ACC;SPRL;MASC;PL;LGSPEC02
garðr	garðana	N;ACC;DEF;MASC;PL
saga	sǫgur	N;NOM;INDF;FEM;PL
vǫrr	verrir	N;NOM;INDF;MASC;PL
nýtr	nýt	ADJ;ACC;NEUT;PL;LGSPEC01
úkyrr	úkyrra	ADJ;GEN;NEUT;SG;LGSPEC02
hvǫnn	hvǫnn	N;ACC;INDF;FEM;SG
mjár	mjávastr	ADJ;NOM;SPRL;MASC;SG;LGSPEC01
skrefa	skrefaði	V;SBJV;SG;3;PST;ACT;LGSPEC02
tíðr	tíðari	ADJ;ACC;CMPR;FEM;PL
nýjastr	nýjasta	ADJ;ACC;FEM;SG;LGSPEC01
byrja	byrjaði	V;SBJV;PL;3;PST;ACT;LGSPEC02
fok	fok	N;ACC;INDF;NEUT;PL
skreyta	skreyttum	V;IND;PL;1;PST;ACT;LGSPEC02
rymja	rumdr	V.PTCP;PST;ACT;LGSPEC02
litinn	litinni	V.PTCP;DAT;FEM;SG;LGSPEC01
erja	erðisk	V;SBJV;SG;3;PST;MID+PASS;LGSPEC02
sáð	sáðs	N;GEN;INDF;NEUT;SG
svelga	svelga	V;NFIN;ACT;LGSPEC01
blótinn	blótins	V.PTCP;GEN;MASC;SG;LGSPEC01
tvíbreiðr	tvíbreiðu	ADJ;ACC;MASC;PL;LGSPEC02
áttr	áttri	V.PTCP;DAT;FEM;SG;LGSPEC01
blindleikr	blindleik	N;ACC;INDF;MASC;SG
hentr	hentir	ADJ;NOM;MASC;PL;LGSPEC01
frjósamr	frjósǫmu	ADJ;ACC;MASC;PL;LGSPEC02
grátinn	grátnu	V.PTCP;NOM;FEM;PL;LGSPEC02
jafn	jǫfnustu	ADJ;ACC;SPRL;NEUT;PL;LGSPEC02
virðar	virða	N;ACC;INDF;MASC;PL
sefi	sefunum	N;DAT;DEF;MASC;PL
manga	mǫnguðum	V;IND;PL;1;PST;ACT;LGSPEC02
sterkleikr	sterkleiks	N;GEN;INDF;MASC;SG
grautarketill	grautarketilinn	N;ACC;DEF;MASC;SG
gjósa	gjósask	V;NFIN;MID+PASS;LGSPEC01
sama	sǫmduzk	V;IND;PL;2;PST;MID+PASS;LGSPEC02
grána	gránaði	V;SBJV;PL;3;PST;ACT;LGSPEC02
tjúgari	tjúgaranum	N;DAT;DEF;MASC;SG
óðr	óðu	ADJ;GEN;NEUT;PL;LGSPEC02
jarldómr	jarldóm	N;ACC;INDF;MASC;SG
tak	tǫk	N;ACC;INDF;NEUT;PL
hvískr	hvískri	N;DAT;INDF;NEUT;SG
sefi	sefa	N;DAT;INDF;MASC;SG
klettr	klettar	N;NOM;INDF;MASC;PL
fleygðr	fleygðra	V.PTCP;GEN;NEUT;PL;LGSPEC01
laginn	lǫgnum	V.PTCP;DAT;FEM;PL;LGSPEC01
leikinn	leiknast	ADJ;NOM;SPRL;NEUT;SG;LGSPEC01
kyrr	kyrrust	ADJ;NOM;SPRL;FEM;SG;LGSPEC01
flatr	flǫtust	ADJ;ACC;SPRL;NEUT;PL;LGSPEC01
kvikr	kvikva	ADJ;NOM;FEM;SG;LGSPEC02
valr	valinn	N;ACC;DEF;MASC;SG
hǫldr	hǫlda	N;ACC;INDF;MASC;PL
festa	festumsk	V;IND;PL;1;PRS;MID+PASS;LGSPEC02
fjǫlmennr	fjǫlmennstar	ADJ;ACC;SPRL;FEM;PL;LGSPEC01
taka	tǫkum	V;IND;PL;1;PRS;ACT;LGSPEC01
skart	skart	N;NOM;INDF;NEUT;SG
kroppr	kroppinn	N;ACC;DEF;MASC;SG
etall	etlari	ADJ;NOM;CMPR;MASC;PL
þarfr	þarfasta	ADJ;ACC;SPRL;FEM;SG;LGSPEC01
spǫrr	spǫrvana	N;ACC;DEF;MASC;PL
orri	orrann	N;ACC;DEF;MASC;SG
øx	øxar	N;ACC;INDF;FEM;PL
bregða	brogðizk	V.PTCP;PST;MID+PASS;LGSPEC01
berr	berra	ADJ;GEN;FEM;PL;LGSPEC01
hnitinn	hnitnu	V.PTCP;GEN;FEM;PL;LGSPEC02
skœðleikr	skœðleikar	N;NOM;INDF;MASC;PL
veikr	veika	ADJ;ACC;MASC;SG;LGSPEC02
hverfi	hverfi	N;ACC;INDF;NEUT;SG
skepja	skepir	V;SBJV;SG;2;PRS;ACT;LGSPEC01
lykill	lyklana	N;ACC;DEF;MASC;PL
þráðr	þráðinn	N;ACC;DEF;MASC;SG
hvalr	hvalirnir	N;NOM;DEF;MASC;PL
hryggva	hrygði	V;SBJV;PL;3;PST;ACT;LGSPEC02
fjǫlmennstr	fjǫlmennstu	ADJ;DAT;FEM;SG;LGSPEC02
gráta	grátum	V;IND;PL;1;PRS;ACT;LGSPEC01
vándr	verra	ADJ;DAT;CMPR;MASC;SG
svima	svæmið	V;SBJV;PL;2;PST;ACT;LGSPEC01
súpa	sypið	V;SBJV;PL;2;PST;ACT;LGSPEC01
hljóðr	hljóðustu	ADJ;DAT;SPRL;FEM;SG;LGSPEC02
valskr	valska	ADJ;ACC;MASC;SG;LGSPEC02
haugr	hauginn	N;ACC;DEF;MASC;SG
jata	jǫtur	N;NOM;INDF;FEM;PL
trýni	trýna	N;ACC;INDF;MASC;SG
bleikr	bleika	ADJ;ACC;MASC;SG;LGSPEC02
stríða	stríddi	V;SBJV;PL;3;PST;ACT;LGSPEC02
þeginn	þegnum	V.PTCP;DAT;FEM;PL;LGSPEC01
hvass	hvassari	ADJ;NOM;CMPR;MASC;PL
róa	rerið	V;SBJV;PL;2;PST;ACT;LGSPEC01
athugasamligr	athugasamliga	ADJ;ACC;NEUT;SG;LGSPEC02
stolinn	stolinnar	V.PTCP;GEN;FEM;SG;LGSPEC01
smeygðr	smeygðs	V.PTCP;GEN;MASC;SG;LGSPEC01
staðr	stað	N;DAT;INDF;MASC;SG
gjósa	gaus	V;IND;SG;1;PST;ACT;LGSPEC01
magr	magra	ADJ;NOM;FEM;SG;LGSPEC02
trumba	trumbaða	V;SBJV;SG;1;PST;ACT;LGSPEC02
slœgr	slœgjust	ADJ;NOM;SPRL;FEM;SG;LGSPEC01
sýsl	sýslum	ADJ;DAT;FEM;PL;LGSPEC02
jara	jǫrunnar	N;GEN;DEF;FEM;SG
saxa	sǫxuðum	V;IND;PL;1;PST;ACT;LGSPEC02
þjórr	þjórsins	N;GEN;DEF;MASC;SG
tǫturr	tǫtursins	N;GEN;DEF;MASC;SG
smá	smáisk	V;SBJV;PL;3;PRS;MID+PASS;LGSPEC02
baðmr	baðmrinn	N;NOM;DEF;MASC;SG
efna	efnandisk	V.PTCP;PRS;MID+PASS;LGSPEC02
deigr	deigasta	ADJ;NOM;SPRL;NEUT;SG;LGSPEC02
etari	etarana	N;ACC;DEF;MASC;PL
reisa	reistisk	V;SBJV;SG;3;PST;MID+PASS;LGSPEC02
hrygð	hrygðir	N;NOM;INDF;FEM;PL
leikinn	leiknustum	ADJ;DAT;SPRL;MASC;SG;LGSPEC01
beita	beitið	V;IND;PL;2;PRS;ACT;LGSPEC02
jakafǫr	jakafaranna	N;GEN;DEF;FEM;PL
auðgastr	auðgustu	ADJ;GEN;MASC;PL;LGSPEC02
leikinn	leikinna	ADJ;GEN;MASC;PL;LGSPEC01
lægja	lægði	V;SBJV;PL;3;PST;ACT;LGSPEC02
andalauss	andalausum	ADJ;DAT;NEUT;PL;LGSPEC02
hvítr	hvítustu	ADJ;ACC;SPRL;NEUT;PL;LGSPEC02
gǫngull	gǫnglari	ADJ;GEN;CMPR;FEM;PL
nyrðri	nyrðra	ADJ;ACC;MASC;SG
tjaldr	tjaldrinn	N;NOM;DEF;MASC;SG
skitinn	skitins	V.PTCP;GEN;MASC;SG;LGSPEC01
skref	skrefin	N;ACC;DEF;NEUT;PL
þrøngva	þrøngðr	V.PTCP;PST;ACT;LGSPEC02
neztr	nezta	ADJ;DAT;NEUT;SG;LGSPEC02
sæti	sæti	N;NOM;INDF;NEUT;SG
atdjúpr	atdjúpari	ADJ;ACC;CMPR;NEUT;PL
hreinn	hreinum	ADJ;DAT;FEM;PL;LGSPEC02
hœgr	hǿgust	ADJ;ACC;SPRL;NEUT;PL;LGSPEC01
hryssa	hryssur	N;NOM;INDF;FEM;PL
leikinn	leikna	ADJ;ACC;NEUT;SG;LGSPEC02
þrǫstr	þrestir	N;NOM;INDF;MASC;PL
hljóðr	hljóðustu	ADJ;DAT;SPRL;NEUT;SG;LGSPEC01
beiskleikr	beiskleikinum	N;DAT;DEF;MASC;SG
beinn	beinir	ADJ;NOM;MASC;PL;LGSPEC01
hlaupa	hlaupizk	V.PTCP;PST;MID+PASS;LGSPEC01
mygla	myglum	V;IMP;PL;1;PRS;ACT;LGSPEC02
kyrr	kyrrasta	ADJ;DAT;SPRL;MASC;SG;LGSPEC02
magn	magnit	N;NOM;DEF;NEUT;SG
eygja	eygðið	V;SBJV;PL;2;PST;ACT;LGSPEC02
kveðja	kvǫddu	V;IND;PL;3;PST;ACT;LGSPEC02
nagl	naglinn	N;ACC;DEF;MASC;SG
vænn	vænsta	ADJ;GEN;SPRL;MASC;SG;LGSPEC02
hǫfugleikr	hǫfugleik	N;ACC;INDF;MASC;SG
faldinn	faldinna	V.PTCP;GEN;MASC;PL;LGSPEC01
slœgr	slœgri	ADJ;DAT;FEM;SG;LGSPEC01
þegn	þegnarnir	N;NOM;DEF;MASC;PL
hlæja	hlæjumk	V;SBJV;SG;1;PRS;MID+PASS;LGSPEC01
karlmannligr	karlmaðrligu	ADJ;ACC;MASC;PL;LGSPEC02
greiða	greiðum	V;IMP;PL;1;PRS;ACT;LGSPEC02
kostnaðr	kostnuðunum	N;DAT;DEF;MASC;PL
byggja	byggim	V;SBJV;PL;1;PRS;ACT;LGSPEC02
eigin	eiginsins	N;GEN;DEF;NEUT;SG
bitlaðr	bitlaða	ADJ;ACC;MASC;SG;LGSPEC02
rjúka	rukumk	V;IND;SG;1;PST;MID+PASS;LGSPEC01
gramr	grǫmu	ADJ;ACC;MASC;PL;LGSPEC02
neðri	neztum	ADJ;DAT;SPRL;MASC;SG;LGSPEC01
garðr	garðar	N;NOM;INDF;MASC;PL
lakr	lakasta	ADJ;NOM;SPRL;FEM;SG;LGSPEC02
fura	furnanna	N;GEN;DEF;FEM;PL
etall	etlastra	ADJ;GEN;SPRL;NEUT;PL;LGSPEC01
syngja	syngja	V;NFIN;ACT;LGSPEC01
aptari	ǫptust	ADJ;NOM;SPRL;FEM;SG;LGSPEC01
þjarka	þjǫrkurnar	N;NOM;DEF;FEM;PL
fjǫrsungr	fjǫrsungar	N;NOM;INDF;MASC;PL
dýrr	dýrst	ADJ;NOM;SPRL;FEM;SG;LGSPEC01
deigr	deigust	ADJ;NOM;SPRL;NEUT;PL;LGSPEC01
ǫlnbogi	ǫlnboga	N;DAT;INDF;MASC;SG
soltinn	soltni	V.PTCP;NOM;MASC;SG;LGSPEC02
syðri	synsta	ADJ;DAT;SPRL;NEUT;SG;LGSPEC02
ǫflugr	ǫflgastum	ADJ;DAT;SPRL;NEUT;PL;LGSPEC02
vænn	vænsti	ADJ;NOM;SPRL;MASC;SG;LGSPEC02
súga	sygisk	V;SBJV;SG;2;PST;MID+PASS;LGSPEC01
atall	atla	ADJ;ACC;MASC;SG;LGSPEC02
ǫrn	ernirnir	N;NOM;DEF;MASC;PL
orpinn	orpin	V.PTCP;ACC;NEUT;PL;LGSPEC01
lauss	laussa	ADJ;GEN;MASC;PL;LGSPEC01
duliðr	duliðu	V.PTCP;ACC;MASC;PL;LGSPEC02
œpa	œpizk	V;IND;PL;2;PRS;MID+PASS;LGSPEC02
upphafligr	upphafligt	ADJ;NOM;NEUT;SG;LGSPEC01
blíðleikr	blíðleikunum	N;DAT;DEF;MASC;PL
skjalla	skullumk	V;IND;SG;1;PST;MID+PASS;LGSPEC01
setja	setið	V;IND;PL;2;PRS;ACT;LGSPEC02
ǫrr	ǫru	ADJ;DAT;FEM;SG;LGSPEC02
bíða	bíðir	V;SBJV;SG;2;PRS;ACT;LGSPEC01
bjǫrk	bjarkar	N;NOM;INDF;FEM;PL
úbrigðr	úbrigðr	ADJ;NOM;MASC;SG;LGSPEC01
fríðleikr	fríðleik	N;ACC;INDF;MASC;SG
sýsl	sýslari	ADJ;ACC;CMPR;FEM;PL
kalfr	kalfinn	N;ACC;DEF;MASC;SG
heiðinn	heiðnu	ADJ;GEN;NEUT;PL;LGSPEC02
spǫrr	spǫrvarnir	N;NOM;DEF;MASC;PL
hvískra	hvískrizk	V;IMP;PL;2;PRS;MID+PASS;LGSPEC02
saltandi	saltǫndum	V.PTCP;DAT;MASC;PL
vafiðr	vafið	V.PTCP;ACC;NEUT;PL;LGSPEC01
ǫskudagr	ǫskudagar	N;NOM;INDF;MASC;PL
salr	sali	N;ACC;INDF;MASC;PL
steðja	steðjumsk	V;IND;PL;1;PRS;MID+PASS;LGSPEC02
erkibiskupligr	erkibiskupliga	ADJ;GEN;NEUT;SG;LGSPEC02
gnógr	gnóga	ADJ;ACC;FEM;SG;LGSPEC01
falki	falkar	N;NOM;INDF;MASC;PL
metja	metja	V;NFIN;ACT;LGSPEC02
festa	festir	V;IND;SG;3;PRS;ACT;LGSPEC02
kvelja	kvelisk	V;SBJV;PL;3;PRS;MID+PASS;LGSPEC02
vekja	vekimsk	V;SBJV;PL;1;PRS;MID+PASS;LGSPEC02
gína	gínisk	V;SBJV;SG;3;PRS;MID+PASS;LGSPEC01
sjaundi	sjaundu	ADJ;NOM;MASC;PL
banalag	banalagi	N;DAT;INDF;NEUT;SG
myrkr	myrkjasta	ADJ;ACC;SPRL;MASC;SG;LGSPEC02
draga	drœgisk	V;SBJV;SG;2;PST;MID+PASS;LGSPEC01
mœða	mœðizk	V;IMP;PL;2;PRS;MID+PASS;LGSPEC02
hringja	hringið	V;IND;PL;2;PRS;ACT;LGSPEC02
fjaðraðr	fjaðraða	ADJ;ACC;NEUT;SG;LGSPEC02
undinn	undins	V.PTCP;GEN;MASC;SG;LGSPEC01
vindr	vindari	ADJ;ACC;CMPR;NEUT;PL
þukla	þuklaðisk	V;SBJV;SG;3;PST;MID+PASS;LGSPEC02
svefja	svafzk	V.PTCP;PST;MID+PASS;LGSPEC02
rǫkstóll	rǫkstóla	N;ACC;INDF;MASC;PL
þunnr	þunnum	ADJ;DAT;FEM;PL;LGSPEC01
eirsamr	eirsamast	ADJ;NOM;SPRL;NEUT;SG;LGSPEC01
hlæja	hlótt	V;IND;SG;2;PST;ACT;LGSPEC01
hvískra	hvískrum	V;IMP;PL;1;PRS;ACT;LGSPEC02
flikki	flikki	N;DAT;INDF;NEUT;SG
vænn	vænum	ADJ;DAT;NEUT;PL;LGSPEC02
svíða	svíða	V;IND;PL;3;PRS;ACT;LGSPEC01
samræði	samræði	N;DAT;INDF;NEUT;SG
kyssa	kystu	V;IND;PL;3;PST;ACT;LGSPEC02
deigr	deigra	ADJ;GEN;FEM;PL;LGSPEC01
hlutr	hlutarins	N;GEN;DEF;MASC;SG
myrkr	myrkjust	ADJ;ACC;SPRL;NEUT;PL;LGSPEC01
þagall	þagalla	ADJ;GEN;FEM;PL;LGSPEC01
kalinn	kalins	V.PTCP;GEN;MASC;SG;LGSPEC01
megin	megin	N;ACC;INDF;NEUT;SG
neztr	neztum	ADJ;DAT;NEUT;PL;LGSPEC02
þungr	þyngstra	ADJ;GEN;SPRL;NEUT;PL;LGSPEC01
reyðarhvalr	reyðarhvalana	N;ACC;DEF;MASC;PL
ausa	jusuð	V;IND;PL;2;PST;ACT;LGSPEC01
frændi	frændanum	N;DAT;DEF;MASC;SG
fylgðr	fylgðra	V.PTCP;GEN;NEUT;PL;LGSPEC01
þíða	þíddum	V;IND;PL;1;PST;ACT;LGSPEC02
geyja	geysk	V;IND;SG;2;PRS;MID+PASS;LGSPEC01
hreinleikr	hreinleiksins	N;GEN;DEF;MASC;SG
kjaptr	kjapta	N;ACC;INDF;MASC;PL
armingi	arminginn	N;NOM;DEF;MASC;SG
angi	anga	N;ACC;INDF;MASC;SG
neðri	nezti	ADJ;NOM;SPRL;MASC;SG;LGSPEC02
stǫð	stǫðvar	N;ACC;INDF;FEM;PL
alinn	alnir	V.PTCP;NOM;MASC;PL;LGSPEC01
atfarardómr	atfarardóm	N;ACC;INDF;MASC;SG
þjónka	þjónkaði	V;SBJV;PL;3;PST;ACT;LGSPEC02
hvískra	hvískrim	V;SBJV;PL;1;PRS;ACT;LGSPEC02
hanzki	hanzkinn	N;NOM;DEF;MASC;SG
víss	vísari	ADJ;GEN;CMPR;FEM;SG
hixtr	hixta	V.PTCP;ACC;MASC;SG;LGSPEC02
hvellr	hvellu	ADJ;GEN;MASC;PL;LGSPEC02
þrøngstr	þrøngst	ADJ;ACC;NEUT;PL;LGSPEC01
digrleikr	digrleika	N;ACC;INDF;MASC;PL
gramr	grǫmustum	ADJ;DAT;SPRL;MASC;SG;LGSPEC01
þykkr	þykkurum	ADJ;DAT;CMPR;NEUT;PL
ǫrleikr	ǫrleika	N;ACC;INDF;MASC;PL
tryggja	tryggisk	V;SBJV;PL;3;PRS;MID+PASS;LGSPEC02
eta	etumk	V;SBJV;SG;1;PRS;MID+PASS;LGSPEC01
norrœna	norrœnar	V;IND;SG;3;PRS;ACT;LGSPEC02
efni	efnit	N;NOM;DEF;NEUT;SG
opna	opna	V;NFIN;ACT;LGSPEC02
brendr	brends	V.PTCP;GEN;MASC;SG;LGSPEC01
tefla	tefldimsk	V;SBJV;PL;1;PST;MID+PASS;LGSPEC02
hreinleikr	hreinleikunum	N;DAT;DEF;MASC;PL
festr	festir	V.PTCP;NOM;MASC;PL;LGSPEC01
veikr	veikari	ADJ;NOM;CMPR;MASC;PL
reisa	reisizk	V;IMP;PL;2;PRS;MID+PASS;LGSPEC02
yrkr	yrkr	ADJ;NOM;MASC;SG;LGSPEC01
keyra	keyrimsk	V;SBJV;PL;1;PRS;MID+PASS;LGSPEC02
dýrri	dýrra	ADJ;DAT;NEUT;SG
œxla	œxlizk	V;IND;PL;2;PRS;MID+PASS;LGSPEC02
sæll	sælustu	ADJ;NOM;SPRL;MASC;PL;LGSPEC02
smíða	smíðumsk	V;IND;PL;1;PRS;MID+PASS;LGSPEC02
atall	ǫtlum	ADJ;DAT;FEM;PL;LGSPEC02
gríss	gríssinn	N;NOM;DEF;MASC;SG
flór	flóa	ADJ;DAT;NEUT;SG;LGSPEC02
hvessa	hvessir	V;IND;SG;3;PRS;ACT;LGSPEC02
sæta	sætizk	V;IMP;PL;2;PRS;MID+PASS;LGSPEC02
áttr	átts	V.PTCP;GEN;MASC;SG;LGSPEC01
vaxa	vaxisk	V;SBJV;PL;3;PRS;MID+PASS;LGSPEC01
tvíbreiðr	tvíbreiðum	ADJ;DAT;FEM;PL;LGSPEC01
galdr	galdr	N;ACC;INDF;MASC;SG
elda	eldumk	V;SBJV;SG;1;PST;MID+PASS;LGSPEC02
staðinn	staðinnar	V.PTCP;GEN;FEM;SG;LGSPEC01
þykt	þyktanna	N;GEN;DEF;FEM;PL
þjóta	þjóta	V;NFIN;ACT;LGSPEC01
ferja	ferim	V;SBJV;PL;1;PRS;ACT;LGSPEC02
grár	grám	ADJ;DAT;FEM;PL;LGSPEC02
úheilagr	úhelgan	ADJ;ACC;MASC;SG;LGSPEC01
dýrr	dýrstan	ADJ;ACC;SPRL;MASC;SG;LGSPEC01
æra	ærði	V;SBJV;PL;3;PST;ACT;LGSPEC02
hrópa	hrópazk	V.PTCP;PST;MID+PASS;LGSPEC02
jǫkulkaldr	jǫkulkalda	ADJ;DAT;NEUT;SG;LGSPEC02
hnitinn	hnitna	V.PTCP;ACC;MASC;PL;LGSPEC01
kosningr	kosningsins	N;GEN;DEF;MASC;SG
etall	etlara	ADJ;DAT;CMPR;MASC;SG
fǿra	fǿrði	V;SBJV;SG;3;PST;ACT;LGSPEC02
lypta	lypti	V;SBJV;SG;3;PST;ACT;LGSPEC02
stórr	stœrstu	ADJ;NOM;SPRL;MASC;PL;LGSPEC02
drukkinn	drukkinna	V.PTCP;GEN;MASC;PL;LGSPEC01
vefr	vef	N;ACC;INDF;MASC;SG
sama	samizk	V;SBJV;PL;2;PRS;MID+PASS;LGSPEC02
verpa	yrpi	V;SBJV;SG;3;PST;ACT;LGSPEC01
hvassleikr	hvassleika	N;ACC;INDF;MASC;PL
maðkr	mǫðkunum	N;DAT;DEF;MASC;PL
arfr	arfinn	N;ACC;DEF;MASC;SG
hnot	hnata	N;GEN;INDF;FEM;PL
gap	gap	N;ACC;INDF;NEUT;SG
ǫxl	axlanna	N;GEN;DEF;FEM;PL
hverfr	hverfasta	ADJ;NOM;SPRL;FEM;SG;LGSPEC02
skagi	skaga	N;DAT;INDF;MASC;SG
krysja	krystið	V;SBJV;PL;2;PST;ACT;LGSPEC02
mið	miðsins	N;GEN;DEF;NEUT;SG
lús	lús	N;ACC;INDF;FEM;SG
líkamr	líkamar	N;NOM;INDF;MASC;PL
þekkr	þekka	ADJ;GEN;NEUT;SG;LGSPEC02
hvítr	hvítari	ADJ;NOM;CMPR;MASC;PL
kveðja	kveðimsk	V;SBJV;PL;1;PRS;MID+PASS;LGSPEC02
hnitinn	hnitnu	V.PTCP;ACC;FEM;SG;LGSPEC02
kviðugr	kviðgum	ADJ;DAT;MASC;PL;LGSPEC02
vangr	vang	N;ACC;INDF;MASC;SG
beinn	beinustu	ADJ;DAT;SPRL;NEUT;SG;LGSPEC01
yfirgefa	yfirgefir	V;SBJV;SG;2;PRS;ACT;LGSPEC01
lítill	minnstu	ADJ;DAT;SPRL;NEUT;SG;LGSPEC01
aumligleikr	aumligleiki	N;DAT;INDF;MASC;SG
stafn	stafnar	N;NOM;INDF;MASC;PL
hníga	hneig	V;IND;SG;3;PST;ACT;LGSPEC01
víss	vísari	ADJ;NOM;CMPR;MASC;PL
gróa	grœsk	V;IND;SG;2;PRS;MID+PASS;LGSPEC01
sannheilagr	sannhelgum	ADJ;DAT;FEM;PL;LGSPEC02
mara	merði	V;SBJV;SG;3;PST;ACT;LGSPEC02
breiðr	breiðurum	ADJ;DAT;CMPR;FEM;PL
stríðr	stríðastar	ADJ;ACC;SPRL;FEM;PL;LGSPEC01
sǫðla	sǫðluðuzk	V;IND;PL;2;PST;MID+PASS;LGSPEC02
kylfuhǫgg	kylfuhǫgg	N;NOM;INDF;NEUT;PL
lǫgrétta	lǫgréttna	N;GEN;INDF;FEM;PL
beinn	beinum	ADJ;DAT;MASC;PL;LGSPEC02
eðla	eðlu	N;ACC;INDF;FEM;SG
djarfr	djarfara	ADJ;GEN;CMPR;MASC;SG
eiginn	eignir	ADJ;NOM;MASC;PL;LGSPEC01
langr	lengstu	ADJ;ACC;SPRL;MASC;PL;LGSPEC02
dýrr	dýrrum	ADJ;DAT;CMPR;FEM;PL
bein	beininu	N;DAT;DEF;NEUT;SG
selja	seljunnar	N;GEN;DEF;FEM;SG
neðri	neztum	ADJ;DAT;SPRL;NEUT;PL;LGSPEC01
úfríðr	úfríðu	ADJ;ACC;MASC;PL;LGSPEC02
angi	angana	N;ACC;DEF;MASC;PL
orðinn	orðinna	V.PTCP;GEN;MASC;PL;LGSPEC01
sǫngr	sǫnginn	N;ACC;DEF;MASC;SG
gǫngull	gǫnglari	ADJ;GEN;CMPR;FEM;SG
refr	refrinn	N;NOM;DEF;MASC;SG
feigr	feigan	ADJ;ACC;MASC;SG;LGSPEC01
dýrr	dýrstra	ADJ;GEN;SPRL;MASC;PL;LGSPEC01
selja	selr	V;IND;SG;3;PRS;ACT;LGSPEC02
garpr	garpar	N;NOM;INDF;MASC;PL
hvass	hvassast	ADJ;NOM;SPRL;NEUT;SG;LGSPEC01
søkkva	søkkva	V;IND;PL;3;PRS;ACT;LGSPEC01
makligr	makliga	ADJ;DAT;NEUT;SG;LGSPEC02
góðr	beztum	ADJ;DAT;SPRL;MASC;SG;LGSPEC01
hrópa	hrópa	V;NFIN;ACT;LGSPEC02
barki	barkana	N;ACC;DEF;MASC;PL
kitla	kitlið	V;IND;PL;2;PRS;ACT;LGSPEC02
fúss	fúsari	ADJ;GEN;CMPR;FEM;PL
hreinn	hreinan	ADJ;ACC;MASC;SG;LGSPEC01
velta	veltumk	V;IND;SG;1;PRS;MID+PASS;LGSPEC01
hjalmr	hjalmi	N;DAT;INDF;MASC;SG
gnyðja	gnuðr	V.PTCP;PST;ACT;LGSPEC02
skera	skarzk	V;IND;SG;2;PST;MID+PASS;LGSPEC01
stríðsmaðr	stríðsmanni	N;DAT;INDF;MASC;SG
suminn	sumnir	V.PTCP;NOM;MASC;PL;LGSPEC01
gǫngull	gǫnglan	ADJ;ACC;MASC;SG;LGSPEC01
treðja	trǫddu	V;IND;PL;3;PST;ACT;LGSPEC02
ǫflugr	ǫflgastt	ADJ;NOM;SPRL;NEUT;SG;LGSPEC01
breiðleikr	breiðleik	N;ACC;INDF;MASC;SG
stǫðugr	stǫðgum	ADJ;DAT;NEUT;PL;LGSPEC02
sveðja	sveðið	V;IND;PL;2;PRS;ACT;LGSPEC02
afleggja	aflegði	V;SBJV;SG;3;PST;ACT;LGSPEC02
birgr	birgu	ADJ;GEN;NEUT;PL;LGSPEC02
máttr	mættinum	N;DAT;DEF;MASC;SG
ǫfund	ǫfundar	N;NOM;INDF;FEM;PL
draf	drafi	N;DAT;INDF;NEUT;SG
linnr	linna	N;ACC;INDF;MASC;PL
sjúkleiki	sjúkleikinn	N;NOM;DEF;MASC;SG
ǫnn	anna	N;GEN;INDF;FEM;PL
tuttugasti	tuttugasta	ADJ;DAT;NEUT;SG
ofinn	ofnu	V.PTCP;GEN;NEUT;PL;LGSPEC02
selr	sel	N;ACC;INDF;MASC;SG
stríð	stríðs	N;GEN;INDF;NEUT;SG
athugasamr	athugasamara	ADJ;DAT;CMPR;NEUT;SG
fit	fitjarinnar	N;GEN;DEF;FEM;SG
róa	rói	V;SBJV;PL;3;PRS;ACT;LGSPEC01
stríðsmaðr	stríðsmann	N;ACC;INDF;MASC;SG
nýtr	nýtasta	ADJ;DAT;SPRL;NEUT;SG;LGSPEC02
apaldr	apaldrana	N;ACC;DEF;MASC;PL
myrkr	myrkri	ADJ;DAT;FEM;SG;LGSPEC01
hlœða	hlœðumsk	V;IMP;PL;1;PRS;MID+PASS;LGSPEC02
lifna	lifnizk	V;IND;PL;2;PRS;MID+PASS;LGSPEC02
vefr	vefirnir	N;NOM;DEF;MASC;PL
kvikna	kviknandisk	V.PTCP;PRS;MID+PASS;LGSPEC02
heimakona	heimakvennanna	N;GEN;DEF;FEM;PL
vaða	vaði	V;SBJV;PL;3;PRS;ACT;LGSPEC01
kreppingr	kreppingi	N;DAT;INDF;MASC;SG
geyja	geyisk	V;SBJV;PL;3;PRS;MID+PASS;LGSPEC01
verr	verana	N;ACC;DEF;MASC;PL
úfríðr	úfríðustum	ADJ;DAT;SPRL;MASC;PL;LGSPEC02
þykt	þyktarinnar	N;GEN;DEF;FEM;SG
nørztr	nørztir	ADJ;NOM;MASC;PL;LGSPEC01
maðr	mennina	N;ACC;DEF;MASC;PL
hœgr	hǿgan	ADJ;ACC;MASC;SG;LGSPEC01
bandingi	bandingja	N;ACC;INDF;MASC;SG
teyging	teyginga	N;GEN;INDF;FEM;PL
djúpastr	djúpustum	ADJ;DAT;FEM;PL;LGSPEC02
vindr	vindar	N;NOM;INDF;MASC;PL
samligr	samlig	ADJ;ACC;NEUT;PL;LGSPEC01
beysti	beysti	N;NOM;INDF;NEUT;PL
daufr	daufum	ADJ;DAT;FEM;PL;LGSPEC01
feitleikr	feitleik	N;ACC;INDF;MASC;SG
þurka	þurkaði	V;SBJV;PL;3;PST;ACT;LGSPEC02
kvikna	kviknaði	V;SBJV;SG;3;PST;ACT;LGSPEC02
helga	helgaðimsk	V;SBJV;PL;1;PST;MID+PASS;LGSPEC02
kærligr	kærligari	ADJ;ACC;CMPR;FEM;PL
þakka	þakkizk	V;IND;PL;2;PRS;MID+PASS;LGSPEC02
finginn	fingit	V.PTCP;ACC;NEUT;SG;LGSPEC01
írska	írskurnar	N;NOM;DEF;FEM;PL
brezkr	brezkustum	ADJ;DAT;SPRL;MASC;PL;LGSPEC02
gramr	gramara	ADJ;NOM;CMPR;NEUT;SG
atdjúpr	atdýpstum	ADJ;DAT;SPRL;MASC;PL;LGSPEC02
hvítr	hvítan	ADJ;ACC;MASC;SG;LGSPEC01
klókr	klóku	ADJ;DAT;FEM;SG;LGSPEC02
floginn	flognu	V.PTCP;GEN;MASC;PL;LGSPEC02
gramr	grǫmu	ADJ;GEN;MASC;PL;LGSPEC02
jarlborinn	jarlbornir	ADJ;NOM;MASC;PL;LGSPEC01
hlaða	hlaðnanna	N;GEN;DEF;FEM;PL
remja	remjuðum	V;IND;PL;1;PST;ACT;LGSPEC02
ýskja	ýskisk	V;SBJV;PL;3;PRS;MID+PASS;LGSPEC02
ǫln	alnir	N;ACC;INDF;FEM;PL
skilja	skilizk	V;IMP;PL;2;PRS;MID+PASS;LGSPEC02
døkkleikr	døkkleikar	N;NOM;INDF;MASC;PL
flúiðr	flúiðum	V.PTCP;DAT;FEM;PL;LGSPEC01
róa	rørisk	V;SBJV;SG;2;PST;MID+PASS;LGSPEC01
detta	dettisk	V;SBJV;SG;3;PRS;MID+PASS;LGSPEC01
vega	vázk	V;IND;SG;2;PST;MID+PASS;LGSPEC01
etall	etla	ADJ;DAT;NEUT;SG;LGSPEC02
draumr	drauminn	N;ACC;DEF;MASC;SG
gnýja	gnýða	V;SBJV;SG;1;PST;ACT;LGSPEC02
telgja	telgumsk	V;IND;PL;1;PRS;MID+PASS;LGSPEC02
hvellr	hvellari	ADJ;NOM;CMPR;NEUT;PL
framr	framri	ADJ;DAT;FEM;SG;LGSPEC01
skila	skilaði	V;SBJV;SG;3;PST;ACT;LGSPEC02
dáinn	dána	V.PTCP;ACC;MASC;PL;LGSPEC01
teitr	teitari	ADJ;ACC;CMPR;NEUT;PL
byrgi	byrgit	N;NOM;DEF;NEUT;SG
valtr	valtastan	ADJ;ACC;SPRL;MASC;SG;LGSPEC01
myrkr	myrkja	ADJ;ACC;NEUT;SG;LGSPEC02
hýrr	hýru	ADJ;ACC;MASC;PL;LGSPEC02
gremja	gramdr	V.PTCP;PST;ACT;LGSPEC02
varp	varpi	N;DAT;INDF;NEUT;SG
byggja	byggizk	V;IMP;PL;2;PRS;MID+PASS;LGSPEC02
fáðr	fáðu	V.PTCP;GEN;NEUT;PL;LGSPEC02
veikr	veika	ADJ;DAT;NEUT;SG;LGSPEC02
bíða	bíðumk	V;IND;SG;1;PRS;MID+PASS;LGSPEC01
stela	stáluzk	V;IND;PL;2;PST;MID+PASS;LGSPEC01
beizla	beizlur	N;NOM;INDF;FEM;PL
buð	buð	N;NOM;INDF;NEUT;PL
rimi	rimunum	N;DAT;DEF;MASC;PL
krjúpa	krjúpum	V;IND;PL;1;PRS;ACT;LGSPEC01
fara	farizk	V.PTCP;PST;MID+PASS;LGSPEC01
kjalki	kjalkinn	N;NOM;DEF;MASC;SG
geil	geilar	N;NOM;INDF;FEM;PL
trúnaðarmaðr	trúnaðarmaðrinn	N;NOM;DEF;MASC;SG
þyrstr	þyrsta	ADJ;ACC;MASC;SG;LGSPEC02
skjóta	skutuzk	V;IND;PL;2;PST;MID+PASS;LGSPEC01
hvatr	hvatra	ADJ;GEN;MASC;PL;LGSPEC01
blána	blánaða	V;SBJV;SG;1;PST;ACT;LGSPEC02
berbeinn	berbeinasta	ADJ;NOM;SPRL;FEM;SG;LGSPEC02
samr	samra	ADJ;GEN;FEM;PL;LGSPEC01
gera	gerizk	V;IND;PL;2;PRS;MID+PASS;LGSPEC02
fljóta	fljótisk	V;SBJV;SG;3;PRS;MID+PASS;LGSPEC01
gjalda	gulduð	V;IND;PL;2;PST;ACT;LGSPEC01
finginn	fingnu	V.PTCP;ACC;FEM;SG;LGSPEC02
merja	merizk	V;IND;PL;2;PRS;MID+PASS;LGSPEC02
þykkr	þykkum	ADJ;DAT;MASC;PL;LGSPEC02
sæll	sælu	ADJ;DAT;FEM;SG;LGSPEC02
hraðr	hraðir	ADJ;NOM;MASC;PL;LGSPEC01
vǫkva	vǫkunnar	N;GEN;DEF;FEM;SG
spá	spáðr	V.PTCP;PST;ACT;LGSPEC02
hrafn	hrafninn	N;NOM;DEF;MASC;SG
teygja	teygisk	V;SBJV;PL;3;PRS;MID+PASS;LGSPEC02
minnigr	minnigustum	ADJ;DAT;SPRL;NEUT;PL;LGSPEC01
þjórr	þjórrinn	N;NOM;DEF;MASC;SG
fylja	fyljurnar	N;NOM;DEF;FEM;PL
þunnr	þunnari	ADJ;GEN;CMPR;FEM;PL
visinn	visin	ADJ;ACC;NEUT;PL;LGSPEC01
svífa	sveift	V;IND;SG;2;PST;ACT;LGSPEC01
hljóðr	hljóðust	ADJ;NOM;SPRL;FEM;SG;LGSPEC01
vitr	vitrasta	ADJ;ACC;SPRL;MASC;SG;LGSPEC02
gína	gein	V;IND;SG;3;PST;ACT;LGSPEC01
brezkr	brezkastan	ADJ;ACC;SPRL;MASC;SG;LGSPEC01
ýskja	ýskta	V;SBJV;SG;1;PST;ACT;LGSPEC02
auðigr	auðgu	ADJ;GEN;NEUT;PL;LGSPEC02
vissa	vissna	N;GEN;INDF;FEM;PL
melja	meljandisk	V.PTCP;PRS;MID+PASS;LGSPEC02
visinn	visnasta	ADJ;NOM;SPRL;NEUT;SG;LGSPEC02
brigða	brigðimsk	V;SBJV;PL;1;PRS;MID+PASS;LGSPEC02
skip	skip	N;NOM;INDF;NEUT;PL
lemja	lǫmdu	V;IND;PL;3;PST;ACT;LGSPEC02
gramr	gramari	ADJ;ACC;CMPR;FEM;PL
ellztr	ellztum	ADJ;DAT;FEM;PL;LGSPEC01
norrœna	norrœnimsk	V;SBJV;PL;1;PRS;MID+PASS;LGSPEC02
blár	blár	ADJ;NOM;MASC;SG;LGSPEC01
djarfr	djarfastra	ADJ;GEN;SPRL;NEUT;PL;LGSPEC01
gjarn	gjǫrnum	ADJ;DAT;FEM;PL;LGSPEC01
svala	svǫluðumk	V;SBJV;SG;1;PST;MID+PASS;LGSPEC02
þungi	þunga	N;GEN;INDF;MASC;SG
hǫfugr	hǫfugra	ADJ;GEN;MASC;PL;LGSPEC01
myrkr	myrkasta	ADJ;DAT;SPRL;MASC;SG;LGSPEC02
gildra	gildrizk	V;SBJV;PL;2;PRS;MID+PASS;LGSPEC02
eignaðr	eignaða	V.PTCP;ACC;MASC;SG;LGSPEC02
feðgin	feðgins	N;GEN;INDF;NEUT;SG
velja	velisk	V;SBJV;PL;3;PRS;MID+PASS;LGSPEC02
galinn	galnastra	V.PTCP;GEN;SPRL;FEM;PL;LGSPEC01
hlœða	hlœðið	V;IND;PL;2;PRS;ACT;LGSPEC02
súga	súgisk	V;SBJV;SG;3;PRS;MID+PASS;LGSPEC01
bita	bitaðr	V.PTCP;PST;ACT;LGSPEC02
sunr	synirnir	N;NOM;DEF;MASC;PL
tjara	tjǫrur	N;ACC;INDF;FEM;PL
míga	mígisk	V;SBJV;PL;3;PRS;MID+PASS;LGSPEC01
vænn	vænstum	ADJ;DAT;SPRL;NEUT;PL;LGSPEC01
láta	létir	V;SBJV;SG;2;PST;ACT;LGSPEC01
ǫ́ss	æsinum	N;DAT;DEF;MASC;SG
róa	røra	V;IND;SG;1;PST;ACT;LGSPEC01
sannheilagr	sannhelgu	ADJ;DAT;FEM;SG;LGSPEC02
fluttr	fluttu	V.PTCP;GEN;NEUT;PL;LGSPEC02
ǫskubakaðr	ǫskubakaða	ADJ;ACC;NEUT;SG;LGSPEC02
arfsalsmaðr	arfsalsmanns	N;GEN;INDF;MASC;SG
mintr	minta	V.PTCP;ACC;MASC;SG;LGSPEC02
búfjáreyrir	búfjáraura	N;ACC;INDF;MASC;PL
feginn	fegna	ADJ;ACC;NEUT;SG;LGSPEC02
beini	beinunum	N;DAT;DEF;MASC;PL
vápna	vápnaðr	V.PTCP;PST;ACT;LGSPEC02
dáinn	dáinna	V.PTCP;GEN;MASC;PL;LGSPEC01
heiðinn	heiðnu	ADJ;GEN;MASC;PL;LGSPEC02
þvá	þóguzk	V;IND;PL;2;PST;MID+PASS;LGSPEC01
hraðr	hraða	ADJ;GEN;NEUT;SG;LGSPEC02
óss	ós	N;ACC;INDF;MASC;SG
gerðing	gerðingar	N;NOM;INDF;FEM;PL
jarlborinn	jarlborna	ADJ;ACC;MASC;SG;LGSPEC02
stórr	stœrstum	ADJ;DAT;SPRL;MASC;SG;LGSPEC01
norðmaðr	norðmanni	N;DAT;INDF;MASC;SG
staðr	staða	ADJ;ACC;NEUT;SG;LGSPEC02
vǫxtr	vaxtarins	N;GEN;DEF;MASC;SG
rymja	rymim	V;SBJV;PL;1;PRS;ACT;LGSPEC02
bera	berazk	V.PTCP;PST;MID+PASS;LGSPEC02
fœrðr	fœrðs	V.PTCP;GEN;MASC;SG;LGSPEC01
jalda	jǫldurnar	N;NOM;DEF;FEM;PL
lǫgn	lagnarinnar	N;GEN;DEF;FEM;PL
hryggr	hryggvan	ADJ;ACC;MASC;SG;LGSPEC01
festr	festu	V.PTCP;ACC;MASC;PL;LGSPEC02
selr	selarnir	N;NOM;DEF;MASC;PL
akarn	ǫkurnin	N;ACC;DEF;NEUT;PL
blótmaðr	blótmennina	N;ACC;DEF;MASC;PL
staða	stǫður	N;ACC;INDF;FEM;PL
þykkja	þykkir	V;IND;SG;3;PRS;ACT;LGSPEC02
fluttr	fluttu	V.PTCP;ACC;FEM;SG;LGSPEC02
etall	etlast	ADJ;NOM;SPRL;NEUT;SG;LGSPEC01
numinn	numinnar	V.PTCP;GEN;FEM;SG;LGSPEC01
hitta	hittisk	V;SBJV;SG;3;PST;MID+PASS;LGSPEC02
vitr	vitrari	ADJ;GEN;CMPR;FEM;SG
lúka	lúka	V;IND;PL;3;PRS;ACT;LGSPEC01
biskupligr	biskupligasta	ADJ;ACC;SPRL;MASC;SG;LGSPEC02
hrjóta	hrauzt	V;IND;SG;2;PST;ACT;LGSPEC01
ættingi	ættingjunum	N;DAT;DEF;MASC;PL
messa	messum	V;IMP;PL;1;PRS;ACT;LGSPEC02
ginginn	gingni	V.PTCP;NOM;MASC;SG;LGSPEC02
slœgr	slœgjari	ADJ;NOM;CMPR;MASC;PL
lyptr	lyptrar	V.PTCP;GEN;FEM;SG;LGSPEC01
flórr	flór	N;ACC;INDF;MASC;SG
rísta	rístumk	V;SBJV;SG;1;PRS;MID+PASS;LGSPEC01
hasl	hasl	N;ACC;INDF;MASC;SG
angan	anganarinnar	N;GEN;DEF;FEM;SG
kykr	kykvastar	ADJ;ACC;SPRL;FEM;PL;LGSPEC01
berja	berizk	V;IND;PL;2;PRS;MID+PASS;LGSPEC02
þykkr	þykkurum	ADJ;DAT;CMPR;FEM;PL
líf	lífi	N;DAT;INDF;NEUT;SG
fræ	fræsins	N;GEN;DEF;NEUT;SG
hafinn	hǫfnum	V.PTCP;DAT;FEM;PL;LGSPEC01
jafn	jafnari	ADJ;NOM;CMPR;MASC;PL
ljúfr	ljúfasta	ADJ;DAT;SPRL;NEUT;SG;LGSPEC02
hnitinn	hnitnum	V.PTCP;DAT;FEM;PL;LGSPEC01
fjórði	fjórðu	ADJ;GEN;FEM;SG
tekinn	teknar	V.PTCP;NOM;FEM;PL;LGSPEC01
mærr	mæru	ADJ;ACC;MASC;PL;LGSPEC02
fyrstr	fyrsta	ADJ;GEN;NEUT;SG;LGSPEC02
slœgr	slœgjasta	ADJ;NOM;SPRL;FEM;SG;LGSPEC02
heilbrigðr	heilbrigðum	ADJ;DAT;FEM;PL;LGSPEC01
smá	smár	V;IND;SG;3;PRS;ACT;LGSPEC02
annsamligr	annsamligu	ADJ;GEN;MASC;PL;LGSPEC02
dilkǽr	dilká	N;ACC;INDF;FEM;SG
gleðja	glǫddum	V;IND;PL;1;PST;ACT;LGSPEC02
fjǫrðr	fjǫrðinn	N;ACC;DEF;MASC;SG
ǫr	ǫr	N;ACC;INDF;FEM;SG
atall	ǫtlum	ADJ;DAT;FEM;PL;LGSPEC01
hvítr	hvítustum	ADJ;DAT;SPRL;NEUT;PL;LGSPEC02
dróttinn	dróttna	N;ACC;INDF;MASC;PL
dyrgja	dyrgju	N;ACC;INDF;FEM;SG
gǫngull	gǫnglustu	ADJ;NOM;SPRL;MASC;PL;LGSPEC02
gamall	gamla	ADJ;ACC;NEUT;SG;LGSPEC02
sétti	séttu	ADJ;GEN;NEUT;PL
kveld	kveld	N;NOM;INDF;NEUT;PL
heyra	heyrumsk	V;IND;PL;1;PRS;MID+PASS;LGSPEC02
jǫfnuðr	jǫfnuðunum	N;DAT;DEF;MASC;PL
gerðing	gerðing	N;ACC;INDF;FEM;SG
beiðslaa	beiðslaurnar	N;NOM;DEF;FEM;PL
hrinr	hrinarnir	N;NOM;DEF;MASC;PL
gráta	grátumk	V;IND;SG;1;PRS;MID+PASS;LGSPEC01
horskleikr	horskleiks	N;GEN;INDF;MASC;SG
arfskipti	arfskipti	N;ACC;INDF;NEUT;PL
kaldr	kaldra	ADJ;GEN;MASC;PL;LGSPEC01
lifnaðr	lifnaði	N;ACC;INDF;MASC;PL
bora	boraðið	V;SBJV;PL;2;PST;ACT;LGSPEC02
bǫlva	bǫlvaðisk	V;IND;SG;3;PST;MID+PASS;LGSPEC02
óðr	óðu	ADJ;ACC;MASC;PL;LGSPEC02
kveðja	kveðim	V;SBJV;PL;1;PRS;ACT;LGSPEC02
þenja	þenizk	V;SBJV;PL;2;PRS;MID+PASS;LGSPEC02
brugðinn	brugðnu	V.PTCP;GEN;NEUT;PL;LGSPEC02
þénasta	þénustunnar	N;GEN;DEF;FEM;SG
jarpr	jarpa	ADJ;ACC;MASC;SG;LGSPEC02
klyppa	klyppizk	V;IND;PL;2;PRS;MID+PASS;LGSPEC02
bleðja	bleðja	V;NFIN;ACT;LGSPEC02
grána	gránuðuzk	V;IND;PL;2;PST;MID+PASS;LGSPEC02
mintr	mintar	V.PTCP;NOM;FEM;PL;LGSPEC01
færeyskr	færeysk	ADJ;ACC;NEUT;PL;LGSPEC01
háss	hásasti	ADJ;NOM;SPRL;MASC;SG;LGSPEC02
valskr	vǫlskustu	ADJ;GEN;SPRL;MASC;PL;LGSPEC02
vápn	vápns	N;GEN;INDF;NEUT;SG
bakstr	bakstrinn	N;ACC;DEF;MASC;SG
eygðr	eygðrar	V.PTCP;GEN;FEM;SG;LGSPEC01
hverfa	hurfumk	V;IND;SG;1;PST;MID+PASS;LGSPEC01
ókyrr	ókyrt	ADJ;NOM;NEUT;SG;LGSPEC01
þjóðann	þjóðan	N;ACC;INDF;MASC;SG
riga	rigaði	V;SBJV;SG;3;PST;ACT;LGSPEC02
fagna	fagnar	V;IND;SG;3;PRS;ACT;LGSPEC02
tiginn	tignum	ADJ;DAT;FEM;PL;LGSPEC01
vegligr	vegligasta	ADJ;ACC;SPRL;MASC;SG;LGSPEC02
nafli	naflarnir	N;NOM;DEF;MASC;PL
þyngstr	þyngsta	ADJ;DAT;NEUT;SG;LGSPEC02
annarr	ǫnnur	ADJ;ACC;NEUT;PL;LGSPEC01
kalinn	kalna	V.PTCP;NOM;NEUT;SG;LGSPEC02
trumba	trumbið	V;IND;PL;2;PRS;ACT;LGSPEC02
kvelja	kveljum	V;IMP;PL;1;PRS;ACT;LGSPEC02
serkr	serkinn	N;ACC;DEF;MASC;SG
kunnigr	kunnigra	ADJ;DAT;NEUT;SG
gnúa	gnerið	V;SBJV;PL;2;PST;ACT;LGSPEC01
þrønging	þrønginga	N;GEN;INDF;FEM;PL
hentugleikr	hentugleikinum	N;DAT;DEF;MASC;SG
þykkr	þykkustu	ADJ;NOM;SPRL;FEM;PL;LGSPEC02
reginkunnr	reginkunnust	ADJ;NOM;SPRL;FEM;SG;LGSPEC01
graðr	graðari	ADJ;GEN;CMPR;FEM;SG
skorinn	skorni	V.PTCP;NOM;MASC;SG;LGSPEC02
fótr	fœtr	N;NOM;INDF;MASC;PL
atdjúpr	atdjúpurum	ADJ;DAT;CMPR;NEUT;PL
líta	litumk	V;IND;SG;1;PST;MID+PASS;LGSPEC01
kjaptr	kjaptsins	N;GEN;DEF;MASC;SG
lófi	lófinn	N;NOM;DEF;MASC;SG
skynda	skyndumsk	V;IND;PL;1;PRS;MID+PASS;LGSPEC02
yppa	ypti	V;SBJV;PL;3;PST;ACT;LGSPEC02
minnstr	minnstu	ADJ;GEN;MASC;PL;LGSPEC02
hlitinn	hlitni	V.PTCP;NOM;MASC;SG;LGSPEC02
ǫrr	ǫrvastr	ADJ;NOM;SPRL;MASC;SG;LGSPEC01
valr	valar	N;NOM;INDF;MASC;PL
kvikr	kvikurum	ADJ;DAT;CMPR;NEUT;PL
vé	vésins	N;GEN;DEF;NEUT;SG
vǫndr	vǫnd	N;ACC;INDF;MASC;SG
bein	beinsins	N;GEN;DEF;NEUT;SG
leikari	leikurum	ADJ;DAT;FEM;PL
kyrr	kyrra	ADJ;NOM;FEM;SG;LGSPEC02
